Дата,Выявлено всего,Заражений за день,Выздоровлений,Выздоровлений за день,Смертей за день,Смертей,"Летальность, %",% Выздоровлений,% Смертей,% прирост,Выздоровевших и умерших,Характерстика ДБ
2020-03-12,34,34,0,0,0,0,0.0,,,,0,0.0
2020-03-13,45,11,0,0,0,0,0.0,,,0.32352941176470584,0,0.0
2020-03-14,59,14,0,0,0,0,0.0,,,0.3111111111111111,0,1.0
2020-03-15,63,4,3,3,0,0,0.0,inf,,0.06779661016949158,3,2.0
2020-03-16,91,28,5,2,0,0,0.0,0.6666666666666667,,0.4444444444444444,5,3.0
2020-03-17,114,23,5,0,0,0,0.0,0.0,,0.25274725274725274,5,4.0
2020-03-18,147,33,5,0,0,0,0.0,0.0,,0.2894736842105263,5,5.0
2020-03-19,199,52,5,0,0,0,0.0,0.0,,0.3537414965986394,5,6.0
2020-03-20,253,54,12,7,0,0,0.0,1.4,,0.27135678391959805,12,7.0
2020-03-21,306,53,16,4,0,0,0.0,0.3333333333333333,,0.20948616600790504,16,8.0
2020-03-22,367,61,16,0,0,0,0.0,0.0,,0.19934640522875813,16,9.0
2020-03-23,438,71,17,1,0,0,0.0,0.0625,,0.1934604904632153,17,10.0
2020-03-24,495,57,22,5,0,0,0.0,0.2941176470588236,,0.13013698630136994,22,11.0
2020-03-25,658,163,29,7,2,2,0.3,0.3181818181818181,inf,0.3292929292929292,31,12.0
2020-03-26,840,182,35,6,0,2,0.24,0.2068965517241379,0.0,0.27659574468085113,37,13.0
2020-03-27,1036,196,42,7,1,3,0.29,0.2,0.5,0.2333333333333334,45,14.0
2020-03-28,1264,228,46,4,2,5,0.4,0.09523809523809534,0.6666666666666667,0.22007722007722008,51,14.0
2020-03-29,1534,270,64,18,3,8,0.52,0.3913043478260869,0.6000000000000001,0.2136075949367089,72,13.0
2020-03-30,1836,302,66,2,1,9,0.49,0.03125,0.125,0.19687092568448492,75,14.0
2020-03-31,2337,501,121,55,8,17,0.73,0.8333333333333333,0.8888888888888888,0.272875816993464,138,13.0
2020-04-01,2777,440,190,69,7,24,0.86,0.5702479338842976,0.411764705882353,0.188275566966196,214,12.0
2020-04-02,3548,771,235,45,6,30,0.85,0.236842105263158,0.25,0.27763773856679874,265,12.0
2020-04-03,4149,601,281,46,4,34,0.82,0.1957446808510639,0.1333333333333333,0.16939120631341598,315,12.0
2020-04-04,4731,582,333,52,9,43,0.91,0.18505338078291825,0.2647058823529411,0.14027476500361535,376,12.0
2020-04-05,5389,658,355,22,2,45,0.84,0.06606606606606613,0.046511627906976834,0.13908264637497347,400,13.0
2020-04-06,6343,954,406,51,2,47,0.74,0.14366197183098595,0.044444444444444516,0.1770272777880868,453,13.0
2020-04-07,7497,1154,494,88,11,58,0.77,0.2167487684729064,0.23404255319148934,0.18193283935046511,552,13.0
2020-04-08,8672,1175,580,86,5,63,0.73,0.1740890688259109,0.0862068965517242,0.15672935841003066,643,14.0
2020-04-09,10131,1459,698,118,13,76,0.75,0.20344827586206904,0.20634920634920628,0.16824261992619927,774,14.0
2020-04-10,11917,1786,795,97,18,94,0.79,0.13896848137535822,0.236842105263158,0.176290593228704,889,14.0
2020-04-11,13584,1667,1045,250,12,106,0.78,0.3144654088050314,0.12765957446808507,0.13988419904338345,1151,14.0
2020-04-12,15759,2175,1291,246,24,130,0.82,0.2354066985645933,0.2264150943396226,0.16011484098939932,1421,14.0
2020-04-13,18328,2569,1470,179,18,148,0.81,0.13865220759101482,0.1384615384615384,0.16301795799225838,1618,14.0
2020-04-14,21102,2774,1694,224,22,170,0.81,0.15238095238095228,0.14864864864864868,0.15135312090790046,1864,14.0
2020-04-15,24490,3388,1986,292,28,198,0.81,0.17237308146399055,0.16470588235294126,0.16055350203772156,2184,15.0
2020-04-16,27938,3448,2304,318,34,232,0.83,0.16012084592145026,0.1717171717171717,0.1407921600653328,2536,15.0
2020-04-17,32008,4070,2590,286,41,273,0.85,0.12413194444444442,0.17672413793103448,0.14567971937862412,2863,15.0
2020-04-18,36793,4785,3057,467,40,313,0.85,0.1803088803088804,0.14652014652014644,0.14949387653086732,3370,16.0
2020-04-19,42853,6060,3291,234,48,361,0.84,0.07654563297350347,0.15335463258785942,0.16470524284510635,3652,16.0
2020-04-20,47121,4268,3446,155,44,405,0.86,0.047098146460042616,0.12188365650969525,0.09959629430844984,3851,17.0
2020-04-21,52763,5642,3873,427,51,456,0.86,0.12391178177597205,0.125925925925926,0.11973430105473135,4329,17.0
2020-04-22,57999,5236,4420,547,57,513,0.88,0.14123418538600574,0.125,0.09923620719064496,4933,17.0
2020-04-23,62773,4774,4891,471,42,555,0.88,0.10656108597285074,0.08187134502923987,0.08231176399593099,5446,17.0
2020-04-24,68622,5849,5568,677,60,615,0.9,0.1384175015334288,0.10810810810810813,0.0931770028515444,6183,18.0
2020-04-25,74588,5966,6250,682,66,681,0.91,0.12248563218390808,0.1073170731707318,0.08694004838098568,6931,18.0
2020-04-26,80949,6361,6767,517,62,743,0.92,0.0827199999999999,0.09104258443465496,0.08528181476913166,7510,18.0
2020-04-27,87147,6198,7346,579,50,793,0.91,0.08556228757204076,0.06729475100942127,0.07656672719860658,8139,19.0
2020-04-28,93558,6411,8456,1110,71,864,0.92,0.15110264089300296,0.08953341740226994,0.07356535508967599,9320,19.0
2020-04-29,99399,5841,10286,1830,108,972,0.98,0.2164143803216652,0.125,0.0624318604502021,11258,19.0
2020-04-30,106498,7099,11619,1333,101,1073,1.01,0.12959362239937788,0.10390946502057608,0.07141922956971403,12692,19.0
2020-05-01,114431,7933,13220,1601,92,1165,1.02,0.1377915483260177,0.0857409133271203,0.07448966177768601,14385,19.0
2020-05-02,124054,9623,15013,1793,57,1222,0.99,0.13562783661119515,0.04892703862660941,0.08409434506383763,16235,19.0
2020-05-03,134687,10633,16639,1626,58,1280,0.95,0.10830613468327456,0.04746317512274967,0.08571267351314749,17919,20.0
2020-05-04,145268,10581,18095,1456,76,1356,0.93,0.08750525872949089,0.05937499999999996,0.07855992040805715,19451,20.0
2020-05-05,155370,10102,19865,1770,95,1451,0.93,0.09781707654048087,0.07005899705014751,0.06954043560866817,21316,20.0
2020-05-06,165929,10559,21327,1462,86,1537,0.93,0.0735967782532092,0.05926946933149546,0.06796035270644274,22864,21.0
2020-05-07,177160,11231,23803,2476,88,1625,0.92,0.1160969662868665,0.05725439167208845,0.06768557636097361,25428,21.0
2020-05-08,187859,10699,26608,2805,98,1723,0.92,0.11784228878712776,0.0603076923076924,0.060391736283585525,28331,21.0
2020-05-09,198676,10817,31916,5308,104,1827,0.92,0.19948887552615746,0.06035983749274521,0.057580419357071026,33743,21.0
2020-05-10,209688,11012,34306,2390,88,1915,0.91,0.07488407068554959,0.04816639299397929,0.0554269262517868,36221,22.0
2020-05-11,221344,11656,39801,5495,94,2009,0.91,0.1601760624963564,0.04908616187989545,0.0555873488230132,41810,22.0
2020-05-12,232243,10899,43512,3711,107,2116,0.91,0.09323886334514198,0.05326032852165263,0.04924009686280173,45628,22.0
2020-05-13,242271,10028,48003,4491,96,2212,0.91,0.10321290678433526,0.045368620037807166,0.04317891174330346,50215,22.0
2020-05-14,252245,9974,53530,5527,93,2305,0.91,0.11513863716851035,0.042043399638336254,0.04116877381114548,55835,22.0
2020-05-15,262843,10598,58226,4696,113,2418,0.92,0.0877265084999066,0.0490238611713667,0.04201470792285278,60644,22.0
2020-05-16,272043,9200,63166,4940,119,2537,0.93,0.08484182324047684,0.04921422663358155,0.035001883253501065,65703,22.0
2020-05-17,281752,9709,67373,4207,94,2631,0.93,0.06660228603995821,0.03705163579030346,0.03568921089680677,70004,22.0
2020-05-18,290678,8926,70209,2836,91,2722,0.94,0.042094013922491236,0.03458760927404025,0.03168034299667788,72931,23.0
2020-05-19,299941,9263,76130,5921,115,2837,0.95,0.08433391730404938,0.04224834680382061,0.031866876750218376,78967,23.0
2020-05-20,308705,8764,85392,9262,135,2972,0.96,0.12166031787731503,0.04758547761720133,0.029219079752351274,88364,22.0
2020-05-21,317554,8849,92681,7289,127,3099,0.98,0.08535928424208361,0.04273216689098258,0.028664906626066914,95780,22.0
2020-05-22,326448,8894,99825,7144,150,3249,1.0,0.07708160248594642,0.0484027105517908,0.028007834887924462,103074,22.0
2020-05-23,335882,9434,107936,8111,139,3388,1.01,0.08125219133483585,0.042782394582948635,0.028898936430917118,111324,22.0
2020-05-24,344481,8599,113299,5363,153,3541,1.03,0.049686851467536375,0.045159386068476914,0.025601252820931064,116840,22.0
2020-05-25,353427,8946,118798,5499,92,3633,1.03,0.048535291573623685,0.0259813611974018,0.025969501946406348,122431,23.0
2020-05-26,362342,8915,131129,12331,174,3807,1.05,0.10379804373811008,0.04789430222956237,0.0252244452178243,134936,22.0
2020-05-27,370680,8338,142208,11079,161,3968,1.07,0.08448931967756934,0.04229051746782253,0.02301140911072963,146176,22.0
2020-05-28,379051,8371,150993,8785,174,4142,1.09,0.061775708820882125,0.04385080645161299,0.02258282076184304,155135,23.0
2020-05-29,387623,8572,159257,8264,232,4374,1.13,0.0547310140205175,0.05601158860453892,0.022614371153222068,163631,23.0
2020-05-30,396575,8952,167469,8212,181,4555,1.15,0.05156445242595309,0.041380887059899514,0.023094604809312136,172024,23.0
2020-05-31,405843,9268,171883,4414,138,4693,1.16,0.026357116839534456,0.030296377607025308,0.023370106537224933,176576,24.0
2020-06-01,414878,9035,175877,3994,162,4855,1.17,0.023236736617350262,0.03451949712337532,0.022262303403040033,180732,24.0
2020-06-02,423741,8863,186985,11108,182,5037,1.19,0.06315777503596265,0.03748712667353238,0.02136290668582097,192022,24.0
2020-06-03,432277,8536,195957,8972,178,5215,1.21,0.04798245848597471,0.03533849513599363,0.02014438064761248,201172,24.0
2020-06-04,441108,8831,204623,8666,169,5384,1.22,0.04422398791571625,0.032406519654841766,0.02042903045963573,210007,24.0
2020-06-05,449834,8726,212680,8057,144,5528,1.23,0.039374850334517715,0.026745913818722045,0.019782003500276483,218208,25.0
2020-06-06,458689,8855,221388,8708,197,5725,1.25,0.04094414143313907,0.035636758321273554,0.0196850393700787,227113,25.0
2020-06-07,467673,8984,226731,5343,134,5859,1.25,0.024134099409182097,0.023406113537117967,0.01958625561110039,232590,25.0
2020-06-08,476658,8985,230688,3957,112,5971,1.25,0.017452399539542363,0.019115890083632125,0.019212141817038786,236659,26.0
2020-06-09,485253,8595,242397,11709,171,6142,1.27,0.05075686641697885,0.02863841902528885,0.018031796382311786,248539,26.0
2020-06-10,493657,8404,252783,10386,216,6358,1.29,0.042847064938922534,0.0351676978183002,0.017318800708084225,259141,26.0
2020-06-11,502436,8779,261150,8367,174,6532,1.3,0.03309953596563053,0.02736709657124892,0.01778360278492963,267682,26.0
2020-06-12,511423,8987,269370,8220,183,6715,1.31,0.031476163124640966,0.028015921616656447,0.017886855241264543,276085,26.0
2020-06-13,520129,8706,274641,5271,114,6829,1.31,0.019567880610313004,0.016976917349218246,0.01702309047500794,281470,27.0
2020-06-14,528964,8835,280050,5409,119,6948,1.31,0.019694801577331944,0.017425684580465672,0.01698617073841291,286998,27.0
2020-06-15,537210,8246,284539,4489,143,7091,1.32,0.016029280485627462,0.02058146229130675,0.01558896257590314,291630,27.0
2020-06-16,545458,8248,294306,9767,193,7284,1.34,0.03432569876185698,0.027217599774361775,0.015353399973939474,301590,27.0
2020-06-17,553301,7843,304342,10036,194,7478,1.35,0.03410056200009515,0.02663371773750689,0.01437874226796554,311820,27.0
2020-06-18,561091,7790,313963,9621,182,7660,1.37,0.0316124622957068,0.02433805830435953,0.014079135949510269,321623,27.0
2020-06-19,569063,7972,324406,10443,181,7841,1.38,0.03326188117708129,0.023629242819843244,0.014208033990921187,332247,27.0
2020-06-20,576952,7889,334592,10186,161,8002,1.39,0.03139892603712635,0.020533095268460592,0.013863139933539824,342594,27.0
2020-06-21,584680,7728,339711,5119,109,8111,1.39,0.015299230107115537,0.013621594601349596,0.013394528487638445,347822,27.0
2020-06-22,592280,7600,344416,4705,95,8206,1.39,0.013850007800748187,0.011712489212180932,0.01299856331668603,352622,28.0
2020-06-23,599705,7425,356429,12013,153,8359,1.39,0.034879331970640186,0.018644893980014562,0.01253630039846021,364788,27.0
2020-06-24,606881,7176,368822,12393,154,8513,1.4,0.034769898072266825,0.018423256370379226,0.011965883225919516,377335,27.0
2020-06-25,613994,7113,375164,6342,92,8605,1.4,0.017195286615223626,0.010807001057206556,0.011720584430885195,383769,27.0
2020-06-26,620794,6800,384152,8988,176,8781,1.41,0.023957522576793174,0.020453224869262158,0.01107502679179273,392933,27.0
2020-06-27,627646,6852,393352,9200,188,8969,1.43,0.023948853578791732,0.02140986220248253,0.011037477810674769,402321,27.0
2020-06-28,634437,6791,399087,5735,104,9073,1.43,0.014579816551078872,0.01159549559594164,0.010819793322987879,408160,27.0
2020-06-29,641156,6719,403430,4343,93,9166,1.43,0.010882338938627443,0.01025019287997364,0.010590492042551023,412596,28.0
2020-06-30,647849,6693,412650,9220,154,9320,1.44,0.02285402672086856,0.016801221907047692,0.010438957133677372,421970,28.0
2020-07-01,654405,6556,422931,10281,216,9536,1.46,0.02491457651762996,0.023175965665235942,0.010119642077089042,432467,27.0
2020-07-02,661165,6760,428978,6047,147,9683,1.46,0.014297840546093843,0.015415268456375752,0.010329994422414224,438661,28.0
2020-07-03,667883,6718,437893,8915,176,9859,1.48,0.020781951521989583,0.01817618506661156,0.010160852434717428,447752,28.0
2020-07-04,674515,6632,446879,8986,168,10027,1.49,0.02052099485490744,0.017040267775636497,0.009929882928596756,456906,28.0
2020-07-05,681251,6736,450750,3871,134,10161,1.49,0.008662300085705565,0.013363917422958059,0.00998643469752336,460911,28.0
2020-07-06,687862,6611,454329,3579,135,10296,1.5,0.007940099833610548,0.013286093888396744,0.009704205938780186,464625,29.0
2020-07-07,694230,6368,463880,9551,198,10494,1.51,0.02102221077677191,0.01923076923076916,0.009257670870029155,474374,29.0
2020-07-08,700792,6562,472511,8631,173,10667,1.52,0.0186061050271622,0.016485610825233366,0.009452198839001502,483178,29.0
2020-07-09,707301,6509,481316,8805,176,10843,1.53,0.01863448681617985,0.016499484391112818,0.009288062649116968,492159,29.0
2020-07-10,713936,6635,489068,7752,174,11017,1.54,0.016105843146706045,0.016047219404223826,0.009380730410391004,500085,29.0
2020-07-11,720547,6611,497446,8378,188,11205,1.56,0.017130542174094376,0.01706453662521556,0.009259933663521736,508651,29.0
2020-07-12,727162,6615,501061,3615,130,11335,1.56,0.007267120451265097,0.011601963409192395,0.00918052535087921,512396,29.0
2020-07-13,733699,6537,504021,2960,104,11439,1.56,0.005907464360626724,0.009175121305690316,0.008989743688476494,515460,30.0
2020-07-14,739947,6248,512825,8804,175,11614,1.57,0.01746752615466418,0.015298540082175016,0.008515753735523601,524439,30.0
2020-07-15,746369,6422,523249,10424,156,11770,1.58,0.02032662214205616,0.013432064749440364,0.008678999982431268,535019,30.0
2020-07-16,752797,6428,531692,8443,167,11937,1.59,0.01613572123405871,0.014188615123194468,0.008612361981807927,543629,30.0
2020-07-17,759203,6406,539373,7681,186,12123,1.6,0.014446333591628282,0.015581804473485894,0.00850959820509378,551496,30.0
2020-07-18,765437,6234,546863,7490,124,12247,1.6,0.01388649413300258,0.01022849129753367,0.008211242579389209,559110,30.0
2020-07-19,771546,6109,550344,3481,95,12342,1.6,0.0063653968178500895,0.007757001714705725,0.007981061798684852,562686,30.0
2020-07-20,777486,5940,553602,3258,85,12427,1.6,0.005919933714185977,0.00688705234159781,0.00769882806728317,566029,31.0
2020-07-21,783328,5842,562384,8782,153,12580,1.61,0.01586338199645243,0.012311901504787892,0.007513961666190783,574964,31.0
2020-07-22,789190,5862,572053,9669,165,12745,1.61,0.017192878887023918,0.013116057233704348,0.00748345520650351,584798,30.0
2020-07-23,795038,5848,580330,8277,147,12892,1.62,0.014468939066834663,0.01153393487642207,0.0074101293731547715,593222,30.0
2020-07-24,800849,5811,588774,8444,154,13046,1.63,0.014550342046766529,0.011945392491467643,0.007309084597214133,601820,30.0
2020-07-25,806720,5871,597140,8366,146,13192,1.64,0.014209187226338129,0.01119116970719003,0.00733097000807903,610332,30.0
2020-07-26,812485,5765,600250,3110,77,13269,1.63,0.005208158890712466,0.005836870830806529,0.007146221737405868,613519,31.0
2020-07-27,818120,5635,603329,3079,85,13354,1.63,0.0051295293627655605,0.006405908508553715,0.006935512655618314,616683,31.0
2020-07-28,823515,5395,612217,8888,150,13504,1.64,0.014731597519761275,0.011232589486296352,0.0065943871314722005,625721,31.0
2020-07-29,828990,5475,620333,8116,169,13673,1.65,0.013256737398667395,0.012514810426540237,0.0066483306315003885,634006,31.0
2020-07-30,834499,5509,629655,9322,129,13802,1.65,0.015027412696084097,0.009434652234330487,0.00664543601249723,643457,30.0
2020-07-31,839981,5482,638410,8755,161,13963,1.66,0.013904439732869587,0.011664976090421721,0.006569210987670493,652373,30.0
2020-08-01,845443,5462,646524,8114,95,14058,1.66,0.012709700662583591,0.006803695480913864,0.006502528033372146,660582,30.0
2020-08-02,850870,5427,650173,3649,70,14128,1.66,0.0056440286826164865,0.004979371176554226,0.006419119917013828,664301,30.0
2020-08-03,856264,5394,653593,3420,79,14207,1.66,0.005260138455457142,0.005591732729331778,0.006339393796937154,667800,31.0
2020-08-04,861423,5159,661471,7878,144,14351,1.67,0.012053372664639905,0.010135848525374858,0.00602501097792274,675822,30.0
2020-08-05,866627,5204,669026,7555,139,14490,1.67,0.011421513565976538,0.00968573618563173,0.006041166767081886,683516,30.0
2020-08-06,871894,5267,676357,7331,116,14606,1.68,0.010957720626702194,0.00800552104899932,0.006077585858737411,690963,30.0
2020-08-07,877135,5241,683592,7235,119,14725,1.68,0.010697013559407331,0.008147336710940811,0.006011051802168543,698317,30.0
2020-08-08,882347,5212,690207,6615,129,14854,1.68,0.009676824772671509,0.008760611205433033,0.0059420727710102214,705061,30.0
2020-08-09,887536,5189,693422,3215,77,14931,1.68,0.00465802288299022,0.005183788878416529,0.0058809062647688926,708353,30.0
2020-08-10,892654,5118,696681,3259,70,15001,1.68,0.004699879726919543,0.0046882325363337704,0.005766526653566696,711682,31.0
2020-08-11,897599,4945,703175,6494,130,15131,1.69,0.009321339321726851,0.008666088927404836,0.005539660383530487,718306,31.0
2020-08-12,902701,5102,710298,7123,129,15260,1.69,0.010129768549792084,0.008525543586015427,0.005684052678311735,725558,31.0
2020-08-13,907758,5057,716396,6098,124,15384,1.69,0.008585129058507945,0.00812581913499355,0.005602076435054393,731780,31.0
2020-08-14,912823,5065,722964,6568,114,15498,1.7,0.009168113724811409,0.007410296411856531,0.005579680928176956,738462,31.0
2020-08-15,917884,5061,729411,6447,119,15617,1.7,0.00891745647086162,0.007678410117434531,0.0055443388258182855,745028,31.0
2020-08-16,922853,4969,732968,3557,68,15685,1.7,0.004876537370563483,0.0043542293654350575,0.005413538094138247,748653,31.0
2020-08-17,927745,4892,736101,3133,55,15740,1.7,0.0042744021567107104,0.003506534905961089,0.005300952589415653,751841,32.0
2020-08-18,932493,4748,742628,6527,132,15872,1.7,0.008866989720160756,0.008386277001270592,0.005117785598413249,758500,32.0
2020-08-19,937321,4828,749423,6795,117,15989,1.71,0.00914993778850248,0.0073714717741935045,0.005177518758853861,765412,32.0
2020-08-20,942106,4785,755513,6090,110,16099,1.71,0.008126251796382045,0.0068797298142473364,0.0051049747098379505,771612,31.0
2020-08-21,946976,4870,761330,5817,90,16189,1.71,0.007699404245856689,0.005590409342195235,0.005169269700012524,777519,31.0
2020-08-22,951897,4921,767477,6147,121,16310,1.71,0.008074028345132822,0.00747421088393363,0.005196541411820466,783787,31.0
2020-08-23,956749,4852,770639,3162,73,16383,1.71,0.0041199931724338335,0.00447578172900065,0.005097190137168139,787022,32.0
2020-08-24,961493,4744,773095,2456,65,16448,1.71,0.0031869656220357982,0.003967527314899577,0.004958458279026079,789543,32.0
2020-08-25,966189,4696,779747,6652,120,16568,1.71,0.008604375917578011,0.007295719844357952,0.004884070918873107,796315,32.0
2020-08-26,970865,4676,786150,6403,115,16683,1.72,0.00821163787741419,0.006941091260260768,0.004839632825461626,802833,32.0
2020-08-27,975576,4711,792561,6411,121,16804,1.72,0.00815493226483488,0.0072528921656775935,0.004852373913983854,809365,32.0
2020-08-28,980405,4829,798466,5905,110,16914,1.73,0.0074505306216177125,0.006546060461794846,0.004949896266410736,815380,32.0
2020-08-29,985346,4941,804383,5917,111,17025,1.73,0.0074104595561990125,0.0065626108549130535,0.00503975397922285,821408,32.0
2020-08-30,990326,4980,806982,2599,68,17093,1.73,0.003231047896337991,0.003994126284875278,0.005054062227887402,824075,32.0
2020-08-31,995319,4993,809387,2405,83,17176,1.73,0.0029802399557858905,0.004855788919440718,0.005041774122864551,826563,33.0
2020-09-01,1000048,4729,815705,6318,123,17299,1.73,0.007805907433650504,0.0071611551001398155,0.004751240557047565,833004,33.0
2020-09-02,1005000,4952,821169,5464,115,17414,1.73,0.006698500070491109,0.0066477831088502795,0.0049517623154089465,838583,33.0
2020-09-03,1009995,4995,826935,5766,114,17528,1.74,0.00702169711715861,0.006546456873779638,0.004970149253731293,844463,33.0
2020-09-04,1015105,5110,832747,5812,121,17649,1.74,0.007028363777080493,0.006903240529438692,0.00505943098728201,850396,33.0
2020-09-05,1020310,5205,838126,5379,110,17759,1.74,0.006459344794997657,0.006232647742081765,0.005127548381694602,855885,33.0
2020-09-06,1025505,5195,840949,2823,61,17820,1.74,0.003368228643426008,0.0034348780899824405,0.005091589810939823,858769,33.0
2020-09-07,1030690,5185,843277,2328,51,17871,1.73,0.002768301050360966,0.002861952861952899,0.005056045558042177,861148,34.0
2020-09-08,1035789,5099,850049,6772,122,17993,1.74,0.008030575955468855,0.006826702478876401,0.0049471713124218395,868042,33.0
2020-09-09,1041007,5218,856458,6409,142,18135,1.74,0.007539565366231794,0.007891957983660271,0.005037705555861249,874593,33.0
2020-09-10,1046370,5363,862373,5915,128,18263,1.75,0.006906351508188413,0.007058174800110395,0.0051517424954874436,880636,33.0
2020-09-11,1051874,5504,868107,5734,102,18365,1.75,0.0066490949971764746,0.005585062695066423,0.005260089643242871,886472,33.0
2020-09-12,1057362,5488,873535,5428,119,18484,1.75,0.006252685440850003,0.006479716852708872,0.005217354930343364,892019,33.0
2020-09-13,1062811,5449,876225,2690,94,18578,1.75,0.0030794415793300445,0.005085479333477583,0.0051533911753969255,894803,33.0
2020-09-14,1068320,5509,878700,2475,57,18635,1.74,0.002824616964820725,0.003068145117881338,0.005183423957787482,897335,34.0
2020-09-15,1073849,5529,884305,5605,150,18785,1.75,0.006378741322408121,0.008049369466058387,0.005175415605811029,903090,33.0
2020-09-16,1079519,5670,890114,5809,132,18917,1.75,0.006569000514528467,0.0070268831514506145,0.005280071965425348,909031,33.0
2020-09-17,1085281,5762,895868,5754,144,19061,1.76,0.0064643405226745285,0.007612200666067492,0.0053375623773179726,914929,33.0
2020-09-18,1091186,5905,901207,5339,134,19195,1.76,0.005959583331472951,0.007030061381879228,0.005440987172907308,920402,33.0
2020-09-19,1097251,6065,906462,5255,144,19339,1.76,0.0058310687777614065,0.00750195363375883,0.00555817248388446,925801,33.0
2020-09-20,1103399,6148,909357,2895,79,19418,1.76,0.00319373564473735,0.004085009566161535,0.005603093549242599,928775,33.0
2020-09-21,1109595,6196,911973,2616,71,19489,1.76,0.0028767579729414017,0.0036564012771656,0.005615375761623964,931462,34.0
2020-09-22,1115810,6215,917949,5976,160,19649,1.76,0.0065528255770730395,0.00820975935142898,0.005601142759295019,937598,33.0
2020-09-23,1122241,6431,923699,5750,150,19799,1.76,0.006263964555765167,0.007633976283780264,0.005763526048341515,943498,33.0
2020-09-24,1128836,6595,929829,6130,149,19948,1.77,0.006636360979063616,0.007525632607707554,0.005876634341464904,949777,33.0
2020-09-25,1136048,7212,934146,4317,108,20056,1.77,0.004642789158006533,0.005414076599157713,0.006388881998802276,954202,33.0
2020-09-26,1143571,7523,940150,6004,169,20225,1.77,0.00642726083502998,0.008426406063023473,0.006622079348759914,960375,33.0
2020-09-27,1151438,7867,943218,3068,99,20324,1.77,0.0032633090464286862,0.004894932014833042,0.006879327999748107,963542,33.0
2020-09-28,1159573,8135,945920,2702,61,20385,1.76,0.002864661191792406,0.003001377681558725,0.007065078623425647,966305,33.0
2020-09-29,1167805,8232,952399,6479,160,20545,1.76,0.006849416441136569,0.007848908511160158,0.007099164951236414,972944,33.0
2020-09-30,1176286,8481,958257,5858,177,20722,1.76,0.00615078344265374,0.008615234850328557,0.007262342600006022,978979,33.0
2020-10-01,1185231,8945,964242,5985,169,20891,1.76,0.0062457148760719505,0.008155583437892133,0.007604443137128269,985133,33.0
2020-10-02,1194643,9412,970296,6054,186,21077,1.76,0.0062785068478659065,0.00890335551194288,0.007941068028089138,991373,32.0
2020-10-03,1204502,9859,975859,5563,174,21251,1.76,0.0057333020026877355,0.008255444323195915,0.008252674648409508,997110,32.0
2020-10-04,1215001,10499,979143,3284,107,21358,1.76,0.0033652402652433193,0.0050350571737800545,0.008716465393996842,1000501,32.0
2020-10-05,1225889,10888,982324,3181,117,21475,1.75,0.0032487593742691607,0.005478041015076318,0.008961309496864578,1003799,33.0
2020-10-06,1237504,11615,988576,6252,188,21663,1.75,0.006364498882242442,0.008754365541327136,0.009474756686779884,1010239,32.0
2020-10-07,1248619,11115,995275,6699,202,21865,1.75,0.0067764137506878255,0.009324654941605505,0.008981789149772545,1017140,32.0
2020-10-08,1260112,11493,1002329,7054,191,22056,1.75,0.007087488382607755,0.008735421907157592,0.00920456920806112,1024385,32.0
2020-10-09,1272238,12126,1009421,7092,201,22257,1.75,0.007075521111331806,0.009113166485310131,0.009622954150107388,1031678,31.0
2020-10-10,1285084,12846,1016202,6781,191,22448,1.75,0.006717712431185907,0.008581569843195469,0.010097167353906977,1038650,31.0
2020-10-11,1298718,13634,1020442,4240,149,22597,1.74,0.00417239879472775,0.006637562366357708,0.010609423197238456,1043039,31.0
2020-10-12,1312310,13592,1024235,3793,125,22722,1.73,0.003717016743724821,0.0055317077488161726,0.010465705411028424,1046957,31.0
2020-10-13,1326178,13868,1031785,7550,244,22966,1.73,0.007371355206568842,0.010738491329988609,0.010567625027622984,1054751,31.0
2020-10-14,1340409,14231,1039705,7920,239,23205,1.73,0.007676017775021027,0.01040668814769652,0.010730837036958762,1062910,30.0
2020-10-15,1354163,13754,1048097,8392,286,23491,1.73,0.00807152028700453,0.012324929971988752,0.010261047187835937,1071588,30.0
2020-10-16,1369313,15150,1056582,8485,232,23723,1.73,0.00809562473702341,0.009876122770422713,0.011187722600602744,1080305,29.0
2020-10-17,1384235,14922,1065199,8617,279,24002,1.73,0.00815554306244093,0.011760738523795444,0.010897435429299218,1089201,29.0
2020-10-18,1399334,15099,1070576,5377,185,24187,1.73,0.005047883071613857,0.007707691025747866,0.010907829956618542,1094763,29.0
2020-10-19,1415316,15982,1075904,5328,179,24366,1.72,0.0049767601739625356,0.007400669781287394,0.011421147488734018,1100270,29.0
2020-10-20,1431635,16319,1085608,9704,269,24635,1.72,0.009019392064719469,0.011039973733891541,0.011530287229141845,1110243,28.0
2020-10-21,1447335,15700,1096560,10952,317,24952,1.72,0.01008835601801028,0.01286787091536423,0.010966482378539144,1121512,28.0
2020-10-22,1463306,15971,1107988,11428,290,25242,1.72,0.01042168235208285,0.01162231484450138,0.011034763893639,1133230,27.0
2020-10-23,1480646,17340,1119251,11263,283,25525,1.72,0.010165272548078086,0.011211472941922151,0.011849879656066431,1144776,26.0
2020-10-24,1497167,16521,1130818,11567,296,25821,1.72,0.010334589828376206,0.011596474045053816,0.01115796753579179,1156639,26.0
2020-10-25,1513877,16710,1138522,7704,229,26050,1.72,0.006812767394930086,0.008868750242051027,0.011161079558926978,1164572,26.0
2020-10-26,1531224,17347,1146096,7574,219,26269,1.72,0.006652484536969761,0.008406909788867491,0.011458658794604835,1172365,26.0
2020-10-27,1547774,16550,1158940,12844,320,26589,1.72,0.011206740098560708,0.012181658989683708,0.010808346786622902,1185529,25.0
2020-10-28,1563976,16202,1171301,12361,346,26935,1.72,0.010665780799696378,0.013012900071458056,0.010467936533369748,1198236,25.0
2020-10-29,1581693,17717,1186041,14740,366,27301,1.73,0.012584297289936595,0.01358826805271951,0.011328178949037593,1213342,25.0
2020-10-30,1599976,18283,1200560,14519,355,27656,1.73,0.01224156669120213,0.013003186696457949,0.011559133156687107,1228216,24.0
2020-10-31,1618116,18140,1215414,14854,334,27990,1.73,0.012372559472246358,0.012076945328319377,0.011337670065050931,1243404,24.0
2020-11-01,1636781,18665,1225673,10259,245,28235,1.73,0.008440745293373242,0.008753126116470167,0.01153501973900517,1253908,24.0
2020-11-02,1655038,18257,1236033,10360,238,28473,1.72,0.008452499157605597,0.008429254471400638,0.011154210612171143,1264506,24.0
2020-11-03,1673686,18648,1251364,15331,355,28828,1.72,0.012403390524363013,0.012467952094967094,0.011267415007993664,1280192,24.0
2020-11-04,1693454,19768,1266931,15567,389,29217,1.73,0.01244002544423517,0.013493825447481678,0.011811056554216215,1296148,24.0
2020-11-05,1712858,19404,1279169,12238,292,29509,1.72,0.00965956314905858,0.00999418146969222,0.011458238605831728,1308678,24.0
2020-11-06,1733440,20582,1296124,16955,378,29887,1.72,0.013254698949083377,0.012809651292825965,0.012016174137027049,1326011,24.0
2020-11-07,1753836,20396,1312927,16803,364,30251,1.72,0.012964037391484108,0.012179208351457138,0.011766199003138356,1343178,23.0
2020-11-08,1774334,20498,1324419,11492,286,30537,1.72,0.008752961893540245,0.009454232917920136,0.011687523804962295,1354956,23.0
2020-11-09,1796132,21798,1335141,10722,256,30793,1.71,0.00809562532703012,0.008383272751088855,0.012285172915584177,1365934,24.0
2020-11-10,1817109,20977,1350741,15600,368,31161,1.71,0.011684159201162949,0.01195076803169548,0.011678985731560898,1381902,24.0
2020-11-11,1836960,19851,1369357,18616,432,31593,1.72,0.01378206480739097,0.01386348320015407,0.010924495998864137,1400950,23.0
2020-11-12,1858568,21608,1388168,18811,439,32032,1.72,0.01373710434897557,0.013895483176653123,0.011762912638271894,1420200,23.0
2020-11-13,1880551,21983,1406903,18735,411,32443,1.73,0.0134962050702796,0.012830919080919044,0.011827923433525234,1439346,23.0
2020-11-14,1903253,22702,1425529,18626,391,32834,1.73,0.013239007948664616,0.012051906420491363,0.012071993793308478,1458363,23.0
2020-11-15,1925825,22572,1439985,14456,352,33186,1.72,0.010140796855062195,0.010720594505695402,0.011859694953850086,1473171,23.0
2020-11-16,1948603,22778,1453849,13864,303,33489,1.72,0.009627878068174223,0.009130356174290366,0.01182765827632304,1487338,23.0
2020-11-17,1971013,22410,1475904,22055,442,33931,1.72,0.015170076122073215,0.01319836364179272,0.011500546801990865,1509835,23.0
2020-11-18,1991998,20985,1501083,25179,456,34387,1.73,0.017060052686353574,0.013439038047802887,0.010646809533980672,1535470,22.0
2020-11-19,2015608,23610,1526656,25573,463,34850,1.73,0.01703636641011852,0.013464390612731636,0.011852421538575795,1561506,22.0
2020-11-20,2039926,24318,1551414,24758,461,35311,1.73,0.01621714387524098,0.013228120516499242,0.012064845942266532,1586725,21.0
2020-11-21,2064748,24822,1577435,26021,467,35778,1.73,0.01677244114079146,0.013225340545439002,0.012168088450267291,1613213,21.0
2020-11-22,2089329,24581,1595443,18008,401,36179,1.73,0.01141600129323872,0.011208004919224024,0.011905084785165164,1631622,21.0
2020-11-23,2114502,25173,1611445,16002,361,36540,1.73,0.010029816170179728,0.009978164128361831,0.012048365767191259,1647985,21.0
2020-11-24,2138828,24326,1634671,23226,491,37031,1.73,0.01441315092975559,0.013437328954570392,0.011504363675229444,1671702,21.0
2020-11-25,2162503,23675,1660419,25748,507,37538,1.74,0.015751181736263664,0.01369123167076225,0.011069146280112241,1697957,20.0
2020-11-26,2187990,25487,1685492,25073,524,38062,1.74,0.015100405379605997,0.013959188022803605,0.011785879603404048,1723554,20.0
2020-11-27,2215533,27543,1712174,26682,496,38558,1.74,0.015830392550068458,0.013031369870211806,0.012588265942714559,1750732,20.0
2020-11-28,2242633,27100,1739470,27296,510,39068,1.74,0.01594230492928883,0.013226827117589046,0.012231819611804529,1778538,19.0
2020-11-29,2269316,26683,1761457,21987,459,39527,1.74,0.01264005702886517,0.011748745776594571,0.011898068029855937,1800984,19.0
2020-11-30,2295654,26338,1778704,17247,368,39895,1.74,0.00979132615783418,0.00931009183596032,0.011606140352423466,1818599,19.0
2020-12-01,2322056,26402,1803467,24763,569,40464,1.74,0.013921934172296258,0.014262438902117982,0.01150086206370826,1843931,19.0
2020-12-02,2347401,25345,1830349,26882,589,41053,1.75,0.01490573434390541,0.01455614867536581,0.010914896109309956,1871402,19.0
2020-12-03,2375546,28145,1859851,29502,554,41607,1.75,0.0161182375601594,0.01349475068813488,0.011989856015226952,1901458,19.0
2020-12-04,2402949,27403,1888752,28901,569,42176,1.76,0.01553941686726512,0.013675583435479588,0.011535453323151756,1930928,18.0
2020-12-05,2431731,28782,1916396,27644,508,42684,1.76,0.014636119511719947,0.012044764795144049,0.011977782299998907,1959080,18.0
2020-12-06,2460770,29039,1937738,21342,457,43141,1.75,0.011136529193340072,0.010706587948645874,0.011941699143531936,1980879,18.0
2020-12-07,2488912,28142,1956588,18850,456,43597,1.75,0.009727837303082243,0.010569991423471814,0.011436257756718415,2000185,18.0
2020-12-08,2515009,26097,1981526,24938,562,44159,1.76,0.01274565723596388,0.012890795238204468,0.010485304422173323,2025685,18.0
2020-12-09,2541199,26190,2007792,26266,559,44718,1.76,0.0132554405039349,0.01265880115038831,0.010413481621735832,2052510,18.0
2020-12-10,2569126,27927,2033669,25877,562,45280,1.76,0.012888287232940554,0.012567646138020416,0.010989694234886828,2078949,18.0
2020-12-11,2597711,28585,2059840,26171,613,45893,1.77,0.012868859189966608,0.0135379858657243,0.011126351918901543,2105733,18.0
2020-12-12,2625848,28137,2085958,26118,560,46453,1.77,0.012679625601988542,0.012202296646547373,0.010831458926724435,2132411,18.0
2020-12-13,2653928,28080,2106235,20277,488,46941,1.77,0.009720713456359055,0.010505241857361236,0.010693688286603107,2153176,18.0
2020-12-14,2681256,27328,2124797,18562,450,47391,1.77,0.008812881753460509,0.009586502204895542,0.010297189675077869,2172188,18.0
2020-12-15,2707945,26689,2149610,24813,577,47968,1.77,0.011677821457767523,0.01217530754784657,0.009953917119439605,2197578,18.0
2020-12-16,2734454,26509,2176100,26490,596,48564,1.78,0.01232316559748048,0.01242494996664445,0.009789342102590748,2224664,18.0
2020-12-17,2762668,28214,2202540,26440,587,49151,1.78,0.012150176922016476,0.012087142739477752,0.01031796475640112,2251691,18.0
2020-12-18,2791220,28552,2228633,26093,611,49762,1.78,0.011846776903030154,0.012431079733881356,0.010334937097038031,2278395,18.0
2020-12-19,2819429,28209,2254742,26109,585,50347,1.79,0.0117152532516569,0.0117559583618021,0.01010633343125944,2305089,18.0
2020-12-20,2848377,28948,2275657,20915,511,50858,1.79,0.009276005857876468,0.01014956203944628,0.010267327178659302,2326515,18.0
2020-12-21,2877727,29350,2295362,19705,493,51351,1.78,0.008659037807543069,0.009693656848480005,0.010304113535532622,2346713,19.0
2020-12-22,2906503,28776,2319520,24158,561,51912,1.79,0.010524701550343796,0.010924811590816041,0.009999558679471663,2371432,19.0
2020-12-23,2933753,27250,2343967,24447,549,52461,1.79,0.010539680623577352,0.010575589459084656,0.009375527911032577,2396428,19.0
2020-12-24,2963688,29935,2370857,26890,635,53096,1.79,0.011472004512008915,0.012104229808810318,0.010203653818164016,2423953,19.0
2020-12-25,2992706,29018,2398254,27397,563,53659,1.79,0.011555737018301926,0.01060343528702723,0.0097911790984746,2451913,19.0
2020-12-26,3021964,29258,2426439,28185,567,54226,1.79,0.011752299798103216,0.010566726923721959,0.009776436442470391,2480665,19.0
2020-12-27,3050248,28284,2450829,24390,552,54778,1.8,0.010051767219369623,0.010179618633127996,0.009359476155242021,2505607,19.0
2020-12-28,3078035,27787,2471309,20480,487,55265,1.8,0.008356356155406974,0.008890430464785215,0.009109751075978112,2526574,19.0
2020-12-29,3105037,27002,2496183,24874,562,55827,1.8,0.010065111242665292,0.010169184836695822,0.008772479845095882,2552010,19.0
2020-12-30,3131550,26513,2525418,29235,599,56426,1.8,0.011711881700981142,0.010729575295108209,0.008538706624107828,2581844,19.0
2020-12-31,3159297,27747,2554340,28922,593,57019,1.8,0.011452361549652457,0.010509339666111341,0.008860468458111725,2611359,19.0
2021-01-01,3186336,27039,2580138,25798,536,57555,1.81,0.010099673496871908,0.009400375313491915,0.008558549576060727,2637693,19.0
2021-01-02,3212637,26301,2599035,18897,447,58002,1.81,0.007324026854377497,0.007766484232473392,0.008254308396854482,2657037,19.0
2021-01-03,3236787,24150,2618882,19847,504,58506,1.81,0.0076362957790103705,0.008689355539464259,0.007517189150221482,2677388,20.0
2021-01-04,3260138,23351,2640036,21154,482,58988,1.81,0.008077492609441794,0.008238471267904224,0.007214252899557572,2699024,20.0
2021-01-05,3284384,24246,2662668,22632,518,59506,1.81,0.00857261037349488,0.008781447073981097,0.007437108490499389,2722174,20.0
2021-01-06,3308601,24217,2685723,23055,445,59951,1.81,0.008658608583571148,0.007478237488656614,0.0073733765601098344,2745674,20.0
2021-01-07,3332142,23541,2709452,23729,506,60457,1.81,0.008835237289921638,0.008440226184717625,0.007115091846977117,2769909,20.0
2021-01-08,3355794,23652,2731129,21677,454,60911,1.82,0.008000510804398786,0.00750946954033438,0.0070981368741187545,2792040,20.0
2021-01-09,3379103,23309,2754809,23680,470,61381,1.82,0.008670407000181957,0.007716176060153401,0.006945897155784975,2816190,21.0
2021-01-10,3401954,22851,2778889,24080,456,61837,1.82,0.008741077875090486,0.007429008976719277,0.006762445536581785,2840726,21.0
2021-01-11,3425269,23315,2800675,21786,436,62273,1.82,0.007839823756904396,0.007050794831573227,0.006853414243696454,2862948,21.0
2021-01-12,3448203,22934,2825430,24755,531,62804,1.82,0.008838940612530877,0.008526969954876007,0.006695532526058479,2888234,21.0
2021-01-13,3471053,22850,2854088,28658,566,63370,1.83,0.010142880906623077,0.00901216483026568,0.006626640020903629,2917458,21.0
2021-01-14,3495816,24763,2882044,27956,570,63940,1.83,0.00979507289193604,0.008994792488559167,0.0071341463238965295,2945984,21.0
2021-01-15,3520531,24715,2909680,27636,555,64495,1.83,0.009589027787223259,0.008680012511729673,0.0070698801081063856,2974175,21.0
2021-01-16,3544623,24092,2936991,27311,590,65085,1.84,0.00938625553325445,0.009147995968679769,0.0068432858565938845,3002076,21.0
2021-01-17,3568209,23586,2960431,23440,481,65566,1.84,0.007980957381210851,0.007390335714834384,0.006654022162582596,3025997,21.0
2021-01-18,3591066,22857,2978764,18333,471,66037,1.84,0.00619267937675283,0.007183601256748996,0.006405734641664829,3044801,22.0
2021-01-19,3612800,21734,3002026,23262,586,66623,1.84,0.007809279284965109,0.008873813165346744,0.006052241869127339,3068649,22.0
2021-01-20,3633952,21152,3027316,25290,597,67220,1.85,0.008424310782118472,0.008960869369436962,0.005854738706820185,3094536,22.0
2021-01-21,3655839,21887,3054218,26902,612,67832,1.86,0.008886419521450641,0.00910443320440346,0.006022919400146209,3122050,22.0
2021-01-22,3677352,21513,3081536,27318,580,68412,1.86,0.008944351712942611,0.008550536619884364,0.005884558920674632,3149948,22.0
2021-01-23,3698273,20921,3109315,27779,559,68971,1.86,0.009014660221396076,0.008171081096883581,0.005689148060887384,3178286,22.0
2021-01-24,3719400,21127,3131760,22445,491,69462,1.87,0.0072186317565123845,0.007118934044743508,0.005712666425653268,3201222,22.0
2021-01-25,3738690,19290,3150763,19003,456,69918,1.87,0.006067834061358468,0.006564740433618432,0.0051863203742539285,3220681,22.0
2021-01-26,3756931,18241,3174561,23798,564,70482,1.88,0.007553091108407628,0.008066592293829887,0.004878981675399574,3245043,22.0
2021-01-27,3774672,17741,3202483,27922,594,71076,1.88,0.008795546848839875,0.00842768366391411,0.004722205438428384,3273559,22.0
2021-01-28,3793810,19138,3229258,26775,575,71651,1.89,0.008360700119251163,0.008089931903877634,0.005070109402883327,3300909,22.0
2021-01-29,3813048,19238,3255462,26204,534,72185,1.89,0.008114557585674477,0.007452792005694375,0.005070891794792143,3327647,22.0
2021-01-30,3832080,19032,3279964,24502,512,72697,1.9,0.0075264278925695205,0.007092886333725845,0.004991282564499544,3352661,22.0
2021-01-31,3850439,18359,3300004,20040,485,73182,1.9,0.006109823156595695,0.006671527023123458,0.004790870754264097,3373186,22.0
2021-02-01,3868087,17648,3318173,18169,437,73619,1.9,0.005505750902120132,0.005971413735618159,0.004583373480270714,3391792,22.0
2021-02-02,3884730,16643,3340545,22372,539,74158,1.91,0.006742264493141192,0.0073214795093656795,0.004302643658221861,3414703,22.0
2021-02-03,3901204,16474,3365367,24822,526,74684,1.91,0.0074305240611936,0.0070929636721595015,0.004240706561331242,3440051,22.0
2021-02-04,3917918,16714,3389913,24546,521,75205,1.92,0.007293706748773721,0.006976059129130796,0.004284318379659258,3465118,22.0
2021-02-05,3934606,16688,3413495,23582,527,75732,1.92,0.006956520713068404,0.007007512798351101,0.004259405122822857,3489227,22.0
2021-02-06,3951233,16627,3436326,22831,497,76229,1.93,0.0066884527441815065,0.006562615539005946,0.004225836081173107,3512555,22.0
2021-02-07,3967281,16048,3456210,19884,432,76661,1.93,0.005786412581344047,0.0056671345550904926,0.004061516999883219,3532871,22.0
2021-02-08,3983197,15916,3472091,15881,407,77068,1.93,0.004594917554199496,0.005309088063030654,0.0040118156490553955,3549159,22.0
2021-02-09,3998216,15019,3493886,21795,530,77598,1.94,0.006277197227837704,0.006877043649763825,0.00377058930301466,3571484,22.0
2021-02-10,4012710,14494,3516461,22575,536,78134,1.95,0.006461286945252276,0.006907394520477394,0.003625116802093764,3594595,22.0
2021-02-11,4027748,15038,3538422,21961,553,78687,1.95,0.006245199363792198,0.0070775846622468394,0.003747592026336344,3617109,22.0
2021-02-12,4042837,15089,3559142,20720,507,79194,1.96,0.005855717605192322,0.0064432498379656256,0.003746262179262549,3638336,22.0
2021-02-13,4057698,14861,3577907,18765,502,79696,1.96,0.005272338108454289,0.006338864055357663,0.00367588403885688,3657603,22.0
2021-02-14,4071883,14185,3593101,15194,430,80126,1.97,0.0042466168069768,0.0053955029110619454,0.003495824479791354,3673227,23.0
2021-02-15,4086090,14207,3607036,13935,394,80520,1.97,0.0038782655984344046,0.004917255322866465,0.0034890491696348835,3687556,23.0
2021-02-16,4099323,13233,3624663,17627,459,80979,1.98,0.0048868378358297715,0.005700447093889728,0.003238548343281744,3705642,23.0
2021-02-17,4112151,12828,3642582,17919,467,81446,1.98,0.004943632001099153,0.005766927228046725,0.003129297203465109,3724028,23.0
2021-02-18,4125598,13447,3661312,18730,480,81926,1.99,0.005141956996438157,0.005893475431574258,0.003270064742272316,3743238,23.0
2021-02-19,4139031,13433,3679949,18637,470,82396,1.99,0.0050902518004474215,0.005736884505529449,0.003256012825292309,3762345,23.0
2021-02-20,4151984,12953,3697433,17484,480,82876,2.0,0.00475115280130245,0.0058255255109471715,0.003129476440258516,3780309,23.0
2021-02-21,4164726,12742,3713445,16012,417,83293,2.0,0.004330572048229175,0.00503161349485981,0.003068894292463486,3796738,23.0
2021-02-22,4177330,12604,3726388,12943,337,83630,2.0,0.003485442762717561,0.004045958243789949,0.0030263695618870656,3810018,24.0
2021-02-23,4189153,11823,3739344,12956,417,84047,2.01,0.00347682527960047,0.004986248953724681,0.0028302767557266684,3823391,24.0
2021-02-24,4200902,11749,3751562,12218,383,84430,2.01,0.003267418028402913,0.004556974074030107,0.002804624228334385,3835992,24.0
2021-02-25,4212100,11198,3767664,16102,446,84876,2.02,0.004292078872746964,0.005282482529906485,0.0026656180029906995,3852540,24.0
2021-02-26,4223186,11086,3783386,15722,428,85304,2.02,0.0041728774115739045,0.005042650454781139,0.0026319413119346713,3868690,24.0
2021-02-27,4234720,11534,3799406,16020,439,85743,2.02,0.004234302289007674,0.005146300290725048,0.002731113429529364,3885149,24.0
2021-02-28,4246079,11359,3811797,12391,379,86122,2.03,0.003261299266253737,0.0044201859043886405,0.002682349718517329,3897919,25.0
2021-03-01,4257650,11571,3823074,11277,333,86455,2.03,0.0029584471576005193,0.003866607835396385,0.002725102382692413,3909529,25.0
2021-03-02,4268215,10565,3838040,14966,441,86896,2.04,0.003914650880417092,0.005100919553524985,0.0024814158044930146,3924936,25.0
2021-03-03,4278750,10535,3853734,15694,452,87348,2.04,0.004089066294254318,0.005201620327748069,0.0024682449220576608,3941082,25.0
2021-03-04,4290135,11385,3869857,16123,475,87823,2.05,0.004183734528641514,0.005438018042771553,0.0026608238387380023,3957680,25.0
2021-03-05,4301159,11024,3885321,15464,462,88285,2.05,0.0039960132893799285,0.0052605809412114,0.0025696161076516066,3973606,25.0
2021-03-06,4312181,11022,3900348,15027,441,88726,2.06,0.0038676341028192063,0.004995186045194444,0.002562565113263693,3989074,25.0
2021-03-07,4322776,10595,3911924,11576,368,89094,2.06,0.002967940296609406,0.004147600477875768,0.0024569933404929856,4001018,25.0
2021-03-08,4333029,10253,3922246,10322,379,89473,2.06,0.002638599318391721,0.004253934047186103,0.002371855492859121,4011719,26.0
2021-03-09,4342474,9445,3932177,9931,336,89809,2.07,0.002531967653227163,0.003755322834821717,0.0021797684714319754,4021986,26.0
2021-03-10,4351553,9079,3945527,13350,466,90275,2.07,0.0033950658884378537,0.005188789542250882,0.0020907436636350423,4035802,26.0
2021-03-11,4360823,9270,3959533,14006,459,90734,2.08,0.003549842644594792,0.005084464137357969,0.0021302739504724943,4050267,26.0
2021-03-12,4370617,9794,3973029,13496,486,91220,2.09,0.003408482768043619,0.005356316265126671,0.0022459063346529358,4064249,26.0
2021-03-13,4380525,9908,3985897,12868,475,91695,2.09,0.0032388386795061397,0.0052071914053934965,0.0022669568163946607,4077592,26.0
2021-03-14,4390608,10083,3995129,9232,395,92090,2.1,0.002316166223060856,0.00430775941981576,0.00230177889636507,4087219,26.0
2021-03-15,4400045,9437,4003576,8447,404,92494,2.1,0.002114324718926364,0.004387012704962556,0.002149360635246955,4096070,27.0
2021-03-16,4409438,9393,4014220,10644,443,92937,2.11,0.002658623190867404,0.00478949985945043,0.0021347508945930294,4107157,27.0
2021-03-17,4418436,8998,4024975,10755,427,93364,2.11,0.0026792253538669986,0.004594510259638307,0.002040622863956898,4118339,27.0
2021-03-18,4428239,9803,4037036,12061,460,93824,2.12,0.0029965403511822424,0.004926952572726018,0.002218658366897275,4130860,27.0
2021-03-19,4437938,9699,4049373,12337,443,94267,2.12,0.003055954913456338,0.004721606412005475,0.0021902611850896925,4143640,27.0
2021-03-20,4447570,9632,4060652,11279,392,94659,2.13,0.002785369488066402,0.0041584011371953436,0.0021703773238832547,4155311,27.0
2021-03-21,4456869,9299,4069395,8743,371,95030,2.13,0.0021531025066909852,0.003919331495156221,0.0020908046416356907,4164425,28.0
2021-03-22,4466153,9284,4077185,7790,361,95391,2.14,0.0019142894705477254,0.003798800378827849,0.0020830767069885963,4172576,28.0
2021-03-23,4474610,8457,4088045,10860,427,95818,2.14,0.002663602461011605,0.0044763132790304186,0.0018935759701916852,4183863,28.0
2021-03-24,4483471,8861,4098400,10355,401,96219,2.15,0.0025329956005866183,0.004185017428875559,0.001980284315281189,4194619,28.0
2021-03-25,4492692,9221,4109281,10881,393,96612,2.15,0.002654938512590244,0.004084432388613557,0.002056665471907859,4205893,28.0
2021-03-26,4501859,9167,4120161,10880,405,97017,2.16,0.002647665126819021,0.004192025835299873,0.002040424760922921,4217178,28.0
2021-03-27,4510744,8885,4130498,10337,387,97404,2.16,0.002508882541240487,0.003988991620025306,0.001973629116327258,4227902,28.0
2021-03-28,4519832,9088,4139128,8630,336,97740,2.16,0.0020893364432086337,0.0034495503264753147,0.002014745239366178,4236868,28.0
2021-03-29,4528543,8711,4146408,7280,293,98033,2.16,0.0017588245640145495,0.0029977491303458947,0.0019272840229460628,4244441,29.0
2021-03-30,4536820,8277,4155996,9588,409,98442,2.17,0.002312362893376552,0.00417206450888985,0.0018277401804509539,4254438,29.0
2021-03-31,4545095,8275,4166172,10176,408,98850,2.17,0.002448510537546245,0.0041445724385933405,0.001823964803540745,4265022,29.0
2021-04-01,4554264,9169,4176419,10247,383,99233,2.18,0.002459572000387933,0.003874557410217472,0.0020173395715601394,4275652,29.0
2021-04-02,4563056,8792,4186251,9832,400,99633,2.18,0.0023541699240425817,0.0040309171344210535,0.001930498539390868,4285884,29.0
2021-04-03,4572077,9021,4195869,9618,384,100017,2.19,0.002297521099427602,0.0038541447110898024,0.001976964560592709,4295886,29.0
2021-04-04,4580894,8817,4204081,8212,357,100374,2.19,0.001957163104949089,0.0035693932031555242,0.0019284452120993392,4304455,29.0
2021-04-05,4589540,8646,4211133,7052,343,100717,2.19,0.0016774177281551061,0.0034172195987007825,0.001887404510997115,4311850,30.0
2021-04-06,4597868,8328,4220035,8902,389,101106,2.2,0.0021139204104927427,0.003862307256967457,0.0018145609363902078,4321141,30.0
2021-04-07,4606162,8294,4229480,9445,374,101480,2.2,0.002238133096052586,0.0036990880857714634,0.0018038795372115055,4330960,30.0
2021-04-08,4614834,8672,4239038,9558,365,101845,2.21,0.002259852274984153,0.003596767836026693,0.0018826953980342067,4340883,30.0
2021-04-09,4623984,9150,4248700,9662,402,102247,2.21,0.0022792907258675217,0.0039471746281114495,0.0019827365404692103,4350947,30.0
2021-04-10,4632688,8704,4258279,9579,402,102649,2.22,0.002254571986725296,0.0039316556964996705,0.0018823594545309683,4360928,29.0
2021-04-11,4641390,8702,4265509,7230,337,102986,2.22,0.0016978690217339665,0.0032830324698731594,0.0018783911197990386,4368495,30.0
2021-04-12,4649710,8320,4272165,6656,277,103263,2.22,0.0015604233867516635,0.0026896859767346908,0.0017925664509985673,4375428,30.0
2021-04-13,4657883,8173,4281776,9611,338,103601,2.22,0.0022496790269102007,0.003273195626700698,0.0017577440313480965,4385377,30.0
2021-04-14,4666209,8326,4291223,9447,399,104000,2.23,0.002206327467854541,0.0038513141765041947,0.001787507328973259,4395223,30.0
2021-04-15,4675153,8944,4301448,10225,398,104398,2.23,0.0023827705994305948,0.0038269230769230056,0.0019167594079048114,4405846,30.0
2021-04-16,4684148,8995,4310557,9109,397,104795,2.24,0.0021176589836724435,0.00380275484204673,0.0019240012038108656,4415352,30.0
2021-04-17,4693469,9321,4319389,8832,398,105193,2.24,0.0020489231438072237,0.0037978911207596773,0.001989902966345269,4424582,30.0
2021-04-18,4702101,8632,4326780,7391,389,105582,2.25,0.00171112164243592,0.0036979646934682813,0.001839151382484916,4432362,30.0
2021-04-19,4710690,8589,4333598,6818,346,105928,2.25,0.0015757676609395865,0.0032770737436305093,0.0018266302659173395,4439526,30.0
2021-04-20,4718854,8164,4343229,9631,379,106307,2.25,0.002222402724018302,0.0035779019711501547,0.0017330794427143914,4449536,30.0
2021-04-21,4727125,8271,4352873,9644,399,106706,2.26,0.002220467767184209,0.003753280592999619,0.0017527560717072175,4459579,30.0
2021-04-22,4736121,8996,4361807,8934,397,107103,2.26,0.0020524375510151405,0.003720503064494896,0.0019030594706084254,4468910,30.0
2021-04-23,4744961,8840,4371214,9407,398,107501,2.27,0.0021566749743855422,0.003716049036908364,0.0018665063667080426,4478715,30.0
2021-04-24,4753789,8828,4380468,9254,399,107900,2.27,0.002117032019022691,0.0037115933805267343,0.0018605000125395679,4488368,30.0
2021-04-25,4762569,8780,4388008,7540,332,108232,2.27,0.0017212772699173318,0.0030769230769229767,0.001846947771556584,4496240,30.0
2021-04-26,4771372,8803,4394639,6631,356,108588,2.28,0.0015111640635112609,0.003289230541799082,0.0018483721705659926,4503227,30.0
2021-04-27,4779425,8053,4402678,8039,392,108980,2.28,0.001829274258932312,0.0036099753195564244,0.0016877745017576107,4511658,30.0
2021-04-28,4787273,7848,4411098,8420,387,109367,2.28,0.0019124723634116325,0.003551110295467064,0.0016420385297395426,4520465,30.0
2021-04-29,4796557,9284,4419540,8442,364,109731,2.29,0.0019138092148485164,0.0033282434372343683,0.001939308662781469,4529271,30.0
2021-04-30,4805288,8731,4427946,8406,397,110128,2.29,0.0019020079012748161,0.003617938413028153,0.0018202639935269715,4538074,30.0
2021-05-01,4814558,9270,4436583,8637,392,110520,2.3,0.0019505657928078344,0.0035594944065087115,0.0019291247475696765,4547103,30.0
2021-05-02,4823255,8697,4443922,7339,342,110862,2.3,0.0016542009920696987,0.0030944625407165467,0.0018063963504022509,4554784,30.0
2021-05-03,4831744,8489,4450289,6367,336,111198,2.3,0.0014327434189889132,0.003030795042485268,0.0017600147618153095,4561487,31.0
2021-05-04,4839514,7770,4457044,6755,337,111535,2.3,0.0015178789512322322,0.0030306300473030845,0.0016081149994702224,4568579,31.0
2021-05-05,4847489,7975,4464550,7506,360,111895,2.31,0.0016840758134764044,0.0032276863764737485,0.0016478927429490753,4576445,31.0
2021-05-06,4855128,7639,4472338,7788,351,112246,2.31,0.001744408731003233,0.0031368693864783914,0.0015758674233194991,4584584,31.0
2021-05-07,4863514,8386,4480360,8022,376,112622,2.32,0.0017936926949617684,0.003349785293017105,0.0017272459140109664,4592982,31.0
2021-05-08,4871843,8329,4488615,8255,370,112992,2.32,0.001842485871671018,0.0032853261352132623,0.0017125477586781288,4601607,31.0
2021-05-09,4880262,8419,4496132,7517,334,113326,2.32,0.0016746813883570244,0.0029559614839989035,0.0017280934545715887,4609458,31.0
2021-05-10,4888727,8465,4502906,6774,321,113647,2.32,0.00150662836411386,0.0028325362229320032,0.0017345380227538065,4616553,31.0
2021-05-11,4896842,8115,4509915,7009,329,113976,2.33,0.0015565503699166428,0.00289492903464228,0.0016599413303299837,4623891,32.0
2021-05-12,4905059,8217,4518529,8614,355,114331,2.33,0.0019100138250942587,0.003114690812100695,0.0016780202424337975,4632860,31.0
2021-05-13,4913439,8380,4527878,9349,392,114723,2.33,0.0020690361841209093,0.0034286414008448678,0.001708440204287065,4642601,31.0
2021-05-14,4922901,9462,4537634,9756,393,115116,2.34,0.002154651693353937,0.003425642634868442,0.0019257387748174981,4652750,31.0
2021-05-15,4931691,8790,4547500,9866,364,115480,2.34,0.00217426085929362,0.003162027867542383,0.0017855325548898906,4662980,31.0
2021-05-16,4940245,8554,4556073,8573,391,115871,2.35,0.0018852116547554145,0.0033858676827156486,0.0017344963421268569,4671944,31.0
2021-05-17,4949573,9328,4563254,7181,340,116211,2.35,0.001576138046954112,0.002934297624082039,0.001888165465477876,4679465,31.0
2021-05-18,4957756,8183,4572226,8972,364,116575,2.35,0.001966140828452589,0.0031322336095549463,0.0016532739288823706,4688801,31.0
2021-05-19,4965676,7920,4581787,9561,390,116965,2.36,0.002091103983048903,0.003345485738794673,0.0015974969320797785,4698752,31.0
2021-05-20,4974908,9232,4591770,9983,385,117350,2.36,0.002178844193324592,0.0032915829521651396,0.001859162780656565,4709120,31.0
2021-05-21,4983845,8937,4601120,9350,389,117739,2.36,0.002036251815748624,0.003314870046868368,0.001796415129686757,4718859,30.0
2021-05-22,4992554,8709,4610465,9345,386,118125,2.37,0.0020310272281531816,0.0032784379007806397,0.00174744599801957,4728590,30.0
2021-05-23,5001505,8951,4617762,7297,357,118482,2.37,0.0015827036969155994,0.0030222222222222594,0.0017928699419174075,4736244,30.0
2021-05-24,5009911,8406,4624212,6450,319,118801,2.37,0.001396780518355012,0.0026923920933137327,0.0016806941110725224,4743013,31.0
2021-05-25,5017795,7884,4632955,8743,393,119194,2.38,0.0018907005128656613,0.0033080529625171273,0.0015736806502151255,4752149,31.0
2021-05-26,5026168,8373,4642090,9135,406,119600,2.38,0.0019717437359094703,0.0034062117220665647,0.0016686612346659135,4761690,31.0
2021-05-27,5035207,9039,4651849,9759,402,120002,2.38,0.002102285823842198,0.0033612040133779164,0.0017983879567893266,4771851,30.0
2021-05-28,5044459,9252,4661234,9385,404,120406,2.39,0.002017477351478947,0.003366610556490679,0.0018374616972052227,4781640,30.0
2021-05-29,5053748,9289,4670484,9250,401,120807,2.39,0.0019844530439794283,0.003330398817334768,0.001841426404694646,4791291,30.0
2021-05-30,5063442,9694,4677870,7386,355,121162,2.39,0.001581420683595125,0.0029385714403966645,0.0019181803287382504,4799032,30.0
2021-05-31,5071917,8475,4684585,6715,339,121501,2.4,0.0014354823883520054,0.002797906934517425,0.001673762630242326,4806086,30.0
2021-06-01,5081417,9500,4693579,8994,372,121873,2.4,0.0019199139304761914,0.003061703195858412,0.001873059042567071,4815452,30.0
2021-06-02,5090249,8832,4702599,9020,394,122267,2.4,0.0019217744071209355,0.003232873565104599,0.0017380978573495742,4824866,30.0
2021-06-03,5099182,8933,4711982,9383,393,122660,2.41,0.0019952796315398924,0.003214276951262418,0.0017549239732672641,4834642,30.0
2021-06-04,5108129,8947,4720512,8530,377,123037,2.41,0.0018102785621847415,0.0030735366052503377,0.0017545951487905054,4843549,30.0
2021-06-05,5117274,9145,4729077,8565,399,123436,2.41,0.0018144218254290132,0.0032429269244211856,0.0017902836831253934,4852513,30.0
2021-06-06,5126437,9163,4736446,7369,351,123787,2.41,0.0015582321878031544,0.002843578858679807,0.001790601793064006,4860233,30.0
2021-06-07,5135866,9429,4743202,6756,330,124117,2.42,0.0014263859442291693,0.0026658695985846137,0.0018392891593128624,4867319,30.0
2021-06-08,5145843,9977,4752085,8883,379,124496,2.42,0.0018727855149327512,0.0030535704214571524,0.001942612988734549,4876581,30.0
2021-06-09,5156250,10407,4761899,9814,399,124895,2.42,0.002065198749601427,0.003204922246497821,0.0020224091562839326,4886794,30.0
2021-06-10,5167949,11699,4771995,10096,383,125278,2.42,0.0021201625653965994,0.003066575923776016,0.0022688969696968986,4897273,29.0
2021-06-11,5180454,12505,4782183,10188,396,125674,2.43,0.0021349561346983847,0.003160970002713981,0.0024197220212505144,4907857,29.0
2021-06-12,5193964,13510,4792169,9986,399,126073,2.43,0.0020881676840891483,0.0031748810414247157,0.0026078795410595657,4918242,29.0
2021-06-13,5208687,14723,4801335,9166,357,126430,2.43,0.0019127038299358023,0.00283169274943873,0.0028346365126905577,4927765,29.0
2021-06-14,5222408,13721,4809647,8312,371,126801,2.43,0.0017311851807881864,0.002934430119433617,0.0026342531236758226,4936448,29.0
2021-06-15,5236593,14185,4818244,8597,379,127180,2.43,0.0017874492660272523,0.0029889354184904353,0.002716179969087129,4945424,29.0
2021-06-16,5249990,13397,4828500,10256,396,127576,2.43,0.0021285763029019744,0.0031136971221890075,0.0025583428003665976,4956076,29.0
2021-06-17,5264047,14057,4839705,11205,416,127992,2.43,0.002320596458527557,0.003260801404652902,0.002677528909578841,4967697,28.0
2021-06-18,5281309,17262,4850659,10954,453,128445,2.43,0.00226336109328984,0.0035392837052314885,0.003279226040344918,4979104,28.0
2021-06-19,5299215,17906,4861343,10684,466,128911,2.43,0.002202587318547833,0.0036280119895675256,0.0033904473303871807,4990254,28.0
2021-06-20,5316826,17611,4869972,8629,450,129361,2.43,0.0017750238977172204,0.003490780460938092,0.003323322416622032,4999333,28.0
2021-06-21,5334204,17378,4878333,8361,440,129801,2.43,0.0017168476533335753,0.003401334250662913,0.003268491389411654,5008134,28.0
2021-06-22,5350919,16715,4889450,11117,546,130347,2.44,0.0022788522226753205,0.00420643908752627,0.003133550947807873,5019797,27.0
2021-06-23,5368513,17594,4902110,12660,548,130895,2.44,0.0025892482794589444,0.004204162734853911,0.00328803332661165,5033005,27.0
2021-06-24,5388695,20182,4915615,13505,568,131463,2.44,0.002754936139743869,0.004339355972344139,0.0037593277691607696,5047078,26.0
2021-06-25,5409088,20393,4929639,14024,601,132064,2.44,0.0028529492240543237,0.004571628519050908,0.0037844042017594064,5061703,26.0
2021-06-26,5430753,21665,4943986,14347,619,132683,2.44,0.002910355099024597,0.004687121395686944,0.004005296271756054,5076669,25.0
2021-06-27,5451291,20538,4956714,12728,599,133282,2.44,0.002574440947041623,0.004514519569198683,0.003781796005084326,5089996,25.0
2021-06-28,5472941,21650,4969340,12626,611,133893,2.45,0.002547252070625783,0.0045842649420027035,0.0039715362837904325,5103233,24.0
2021-06-29,5493557,20616,4984037,14697,652,134545,2.45,0.002957535608350437,0.004869560021808495,0.0037668960801879865,5118582,23.0
2021-06-30,5514599,21042,5000393,16356,669,135214,2.45,0.0032816770822527985,0.004972314095655682,0.003830305210267282,5135607,23.0
2021-07-01,5538142,23543,5017321,16928,672,135886,2.45,0.003385333912754529,0.004969899566612979,0.004269213409714867,5153207,22.0
2021-07-02,5561360,23218,5035518,18197,679,136565,2.46,0.0036268359150231078,0.004996835582767867,0.0041923807659680614,5172083,21.0
2021-07-03,5585799,24439,5053417,17899,697,137262,2.46,0.0035545498993350133,0.005103796726833476,0.004394428700893238,5190679,21.0
2021-07-04,5610941,25142,5068901,15484,663,137925,2.46,0.003064065364089208,0.004830178782182948,0.0045010570555796825,5206826,21.0
2021-07-05,5635294,24353,5083441,14540,654,138579,2.46,0.002868471883747503,0.004741707449700927,0.0043402701971024795,5222020,21.0
2021-07-06,5658672,23378,5101852,18411,737,139316,2.46,0.003621759355523224,0.005318266115356574,0.004148496955083347,5241168,20.0
2021-07-07,5682634,23962,5121919,20067,725,140041,2.46,0.003933277562736093,0.005203996669442157,0.004234562455643243,5261960,20.0
2021-07-08,5707452,24818,5143255,21336,734,140775,2.47,0.004165626203772366,0.005241322184217578,0.004367340919721352,5284030,19.0
2021-07-09,5733218,25766,5165087,21832,726,141501,2.47,0.004244782730002727,0.005157165689930743,0.0045144488293549214,5306588,19.0
2021-07-10,5758300,25082,5182837,17750,752,142253,2.47,0.003436534563696636,0.005314450074557886,0.004374855447673465,5325090,19.0
2021-07-11,5783333,25033,5200219,17382,749,143002,2.47,0.0033537616560197487,0.0052652668133537075,0.004347289998784421,5343221,19.0
2021-07-12,5808473,25140,5216648,16429,710,143712,2.47,0.003159290022208605,0.004964965524957732,0.0043469743139465935,5360360,19.0
2021-07-13,5833175,24702,5236214,19566,780,144492,2.48,0.0037506843474968132,0.005427521710086758,0.004252752831940486,5380706,19.0
2021-07-14,5857002,23827,5257483,21269,786,145278,2.48,0.004061904269000438,0.0054397475292748965,0.004084739442927754,5402761,19.0
2021-07-15,5882295,25293,5278976,21493,791,146069,2.48,0.0040880778882215205,0.005444733545340696,0.004318420925927713,5425045,19.0
2021-07-16,5907999,25704,5300908,21932,799,146868,2.49,0.004154593618156177,0.005470017594424448,0.004369723041771857,5447776,19.0
2021-07-17,5933115,25116,5322345,21437,787,147655,2.49,0.004044024155861692,0.005358553258708597,0.004251185553687531,5470000,19.0
2021-07-18,5958133,25018,5341231,18886,764,148419,2.49,0.003548435886812973,0.005174223697131719,0.004216672017987254,5489650,19.0
2021-07-19,5982766,24633,5359995,18764,719,149138,2.49,0.0035130478348530674,0.004844393238062406,0.0041343487968461545,5509133,19.0
2021-07-20,6006536,23770,5382213,22218,784,149922,2.5,0.004145153120478584,0.00525687618179127,0.003973078672975028,5532135,19.0
2021-07-21,6030240,23704,5404797,22584,783,150705,2.5,0.004196043523361226,0.005222715812222446,0.003946367756723745,5555502,19.0
2021-07-22,6054711,24471,5427457,22660,796,151501,2.5,0.0041925718949296096,0.005281842009223325,0.004058047440897772,5578958,19.0
2021-07-23,6078522,23811,5450004,22547,795,152296,2.51,0.004154247560137271,0.0052474901155767925,0.0039326402201524955,5602300,19.0
2021-07-24,6102469,23947,5471956,21952,799,153095,2.51,0.004027886952009618,0.005246362347008482,0.003939609003636102,5625051,19.0
2021-07-25,6126541,24072,5490634,18678,779,153874,2.51,0.0034134046399496576,0.005088343838792975,0.0039446329018630885,5644508,19.0
2021-07-26,6149780,23239,5506834,16200,727,154601,2.51,0.002950478942868928,0.004724644839284142,0.003793168118845447,5661435,19.0
2021-07-27,6172812,23032,5526950,20116,779,155380,2.52,0.003652915631740417,0.0050387772394744346,0.0037451746241328188,5682330,20.0
2021-07-28,6195232,22420,5547529,20579,798,156178,2.52,0.003723391744090421,0.005135796112755831,0.00363205618444229,5703707,20.0
2021-07-29,6218502,23270,5568363,20834,799,156977,2.52,0.003755545937659921,0.00511595743318516,0.003756114379574571,5725340,20.0
2021-07-30,6242066,23564,5588848,20485,794,157771,2.53,0.003678819071242234,0.005058065831300196,0.003789337046124608,5746619,20.0
2021-07-31,6265873,23807,5608619,19771,792,158563,2.53,0.0035375805532731346,0.005019933954909296,0.003813961595407589,5767182,20.0
2021-08-01,6288677,22804,5625890,17271,789,159352,2.53,0.003079367666086741,0.004975940162585291,0.0036393970959833774,5785242,20.0
2021-08-02,6312185,23508,5640783,14893,785,160137,2.54,0.0026472255945282352,0.004926201114513695,0.0037381471492334843,5800920,21.0
2021-08-03,6334195,22010,5659746,18963,788,160925,2.54,0.003361767329110199,0.004920786576493974,0.0034869066733627108,5820671,21.0
2021-08-04,6356784,22589,5679842,20096,790,161715,2.54,0.003550689377226579,0.004909119154885788,0.0035661990197648485,5841557,21.0
2021-08-05,6379904,23120,5700212,20370,794,162509,2.55,0.003586367367261367,0.004909872306217754,0.0036370592425352117,5862721,21.0
2021-08-06,6402564,22660,5720353,20141,792,163301,2.55,0.0035333773550878522,0.004873576232701016,0.003551777581606297,5883654,21.0
2021-08-07,6424884,22320,5739838,19485,793,164094,2.55,0.0034062583200722423,0.004856063343151584,0.003486103379833461,5903932,22.0
2021-08-08,6447750,22866,5755507,15669,787,164881,2.56,0.0027298679858212,0.004796031542896095,0.0035589747612563283,5920388,22.0
2021-08-09,6469910,22160,5769981,14474,769,165650,2.56,0.0025148088604531878,0.0046639697721386755,0.003436857818618799,5935631,22.0
2021-08-10,6491288,21378,5788710,18729,792,166442,2.56,0.003245937898235685,0.004781165107153651,0.003304219069507841,5955152,23.0
2021-08-11,6512859,21571,5808777,20067,799,167241,2.57,0.003466575454635024,0.004800471034955178,0.0033230693199870487,5976018,23.0
2021-08-12,6534791,21932,5828972,20195,808,168049,2.57,0.0034766354432267392,0.004831351163889329,0.003367491911002496,5997021,23.0
2021-08-13,6557068,22277,5848340,19368,815,168864,2.58,0.003322712821403062,0.004849775958202685,0.0034089843118165764,6017204,23.0
2021-08-14,6579212,22144,5867890,19550,819,169683,2.58,0.0033428289052961357,0.004850056850483231,0.0033771191636262628,6037573,23.0
2021-08-15,6600836,21624,5884316,16426,816,170499,2.58,0.0027993026454142807,0.004808967309630319,0.0032867157951439463,6054815,23.0
2021-08-16,6621601,20765,5899917,15601,806,171305,2.59,0.002651285213098653,0.004727300453374994,0.0031458136514830315,6071222,24.0
2021-08-17,6642559,20958,5918324,18407,805,172110,2.59,0.003119874398233025,0.004699220688246132,0.003165095571297627,6090434,24.0
2021-08-18,6663473,20914,5939037,20713,799,172909,2.59,0.003499808391700165,0.0046423798733368216,0.0031484853954628638,6111946,24.0
2021-08-19,6684531,21058,5963054,24017,791,173700,2.6,0.004043921598737343,0.0045746606596532855,0.0031602139004689445,6136754,24.0
2021-08-20,6705523,20992,5983405,20351,785,174485,2.6,0.0034128485168840594,0.004519286125503674,0.0031403848676891943,6157890,24.0
2021-08-21,6726523,21000,6004052,20647,797,175282,2.61,0.0034507107575034728,0.00456772788491855,0.003131746770535182,6179334,24.0
2021-08-22,6747087,20564,6019466,15414,762,176044,2.61,0.0025672662395328505,0.004347280382469343,0.003057151517953605,6195510,24.0
2021-08-23,6766541,19454,6034867,15401,776,176820,2.61,0.002558532600732466,0.004407988911862892,0.0028833183861420864,6211687,25.0
2021-08-24,6785374,18833,6053503,18636,794,177614,2.62,0.0030880547988878515,0.004490442257663263,0.002783253659439877,6231117,25.0
2021-08-25,6804910,19536,6073157,19654,809,178423,2.62,0.00324671516640862,0.004554821128964992,0.0028791338546703127,6251580,25.0
2021-08-26,6824540,19630,6092818,19661,820,179243,2.63,0.0032373607334703625,0.004595820045621979,0.002884681795938482,6272061,25.0
2021-08-27,6844049,19509,6112035,19217,798,180041,2.63,0.0031540413647674907,0.00445205670514337,0.002858654209660916,6292076,25.0
2021-08-28,6863541,19492,6131446,19411,799,180840,2.63,0.003175865321451754,0.004437878038891174,0.002848021690084357,6312286,25.0
2021-08-29,6882827,19286,6148250,16804,797,181637,2.64,0.0027406259469626715,0.004407210794072025,0.0028099198358397803,6329887,26.0
2021-08-30,6901152,18325,6162430,14180,792,182429,2.64,0.0023063473346074392,0.004360345083876061,0.0026624234489693865,6344859,26.0
2021-08-31,6918965,17813,6181054,18624,795,183224,2.65,0.0030221844304925143,0.00435785977010239,0.002581163260858555,6364278,26.0
2021-09-01,6937333,18368,6199379,18325,790,184014,2.65,0.002964704725116452,0.004311662227655777,0.0026547323190679872,6383393,26.0
2021-09-02,6956318,18985,6218048,18669,798,184812,2.66,0.003011430661038705,0.0043366265610225154,0.002736642453230909,6402860,26.0
2021-09-03,6975174,18856,6236738,18690,799,185611,2.66,0.0030057664398859267,0.004323312339025609,0.0027106293875582828,6422349,27.0
2021-09-04,6993954,18780,6255475,18737,796,186407,2.67,0.003004294873377722,0.004288538933576058,0.0026924059528836697,6441882,27.0
2021-09-05,7012599,18645,6270731,15256,793,187200,2.67,0.0024388235905346,0.0042541320873144,0.0026658739820135673,6457931,27.0
2021-09-06,7030455,17856,6285007,14276,790,187990,2.67,0.002276608580403128,0.004220085470085565,0.002546274213027111,6472997,27.0
2021-09-07,7047880,17425,6302250,17243,795,188785,2.68,0.0027435132530480018,0.0042289483483164405,0.0024785024582334447,6491035,28.0
2021-09-08,7065904,18024,6320512,18262,797,189582,2.68,0.0028976952675632273,0.004221733718250853,0.0025573647678451827,6510094,28.0
2021-09-09,7084284,18380,6340151,19639,794,190376,2.69,0.0031071849875452533,0.004188161323332329,0.002601224132113833,6530527,28.0
2021-09-10,7102625,18341,6357272,17121,789,191165,2.69,0.002700408870388138,0.004144429970164286,0.0025889701768027074,6548437,28.0
2021-09-11,7121516,18891,6375160,17888,796,191961,2.7,0.002813785535682678,0.004163942144221,0.0026597208778444963,6567121,28.0
2021-09-12,7140070,18554,6389657,14497,788,192749,2.7,0.0022739821431931877,0.0041050004948921534,0.002605344143016719,6582406,28.0
2021-09-13,7158248,18178,6402126,12469,719,193468,2.7,0.0019514349518292558,0.003730239845602279,0.002545913415414658,6595594,29.0
2021-09-14,7176085,17837,6418033,15907,781,194249,2.71,0.002484643382526297,0.004036843302251514,0.0024918108453353405,6612282,29.0
2021-09-15,7194926,18841,6435072,17039,792,195041,2.71,0.002654863257948392,0.0040772410668781225,0.0026255263141392593,6630113,29.0
2021-09-16,7214520,19594,6452398,17326,794,195835,2.71,0.002692432967339009,0.004070938930788914,0.002723308064599861,6648233,29.0
2021-09-17,7234425,19905,6469017,16619,791,196626,2.72,0.002575631571394066,0.004039114560727253,0.0027590193110560435,6665643,29.0
2021-09-18,7254754,20329,6485264,16247,799,197425,2.72,0.0025115098630905663,0.0040635521243375106,0.002810036734087307,6682689,30.0
2021-09-19,7274928,20174,6498682,13418,793,198218,2.72,0.002068998270540634,0.004016715208307042,0.002780797253773226,6696900,30.0
2021-09-20,7294672,19744,6510674,11992,778,198996,2.73,0.0018452972464262363,0.003924971496029661,0.002713978750030321,6709670,30.0
2021-09-21,7313851,19179,6526111,15437,812,199808,2.73,0.0023710294817402837,0.004080484029829856,0.002629179214637789,6725919,31.0
2021-09-22,7333557,19706,6542213,16102,817,200625,2.74,0.002467319357577491,0.004088925368353591,0.002694339821798453,6742838,31.0
2021-09-23,7354995,21438,6558780,16567,820,201445,2.74,0.0025323235425076533,0.004087227414330208,0.0029232744764922107,6760225,31.0
2021-09-24,7376374,21379,6574608,15828,828,202273,2.74,0.0024132536843741725,0.00411030306038862,0.0029067320915920907,6776881,31.0
2021-09-25,7398415,22041,6590933,16325,822,203095,2.75,0.002483037771985775,0.004063814745418393,0.002988053479934693,6794028,31.0
2021-09-26,7420913,22498,6604604,13671,805,203900,2.75,0.002074213165268013,0.003963662325512596,0.0030409216028026713,6808504,31.0
2021-09-27,7443149,22236,6618117,13513,779,204679,2.75,0.002045997004513911,0.0038205002452182954,0.0029963968045441107,6822796,32.0
2021-09-28,7464708,21559,6635485,17368,852,205531,2.75,0.002624311416676406,0.0041626156078542476,0.0028964891069627186,6841016,32.0
2021-09-29,7487138,22430,6653941,18456,857,206388,2.76,0.0027814093468676577,0.004169687297779889,0.003004806082167022,6860329,32.0
2021-09-30,7511026,23888,6672767,18826,867,207255,2.76,0.002829300710661453,0.004200825629397054,0.003190538227023421,6880022,32.0
2021-10-01,7535548,24522,6692722,19955,887,208142,2.76,0.0029905135305938746,0.004279751996333125,0.0032648003082402788,6900864,32.0
2021-10-02,7560767,25219,6710574,17852,886,209028,2.76,0.0026673750979049338,0.0042567093618779426,0.00334667100521413,6919602,31.0
2021-10-03,7586536,25769,6725965,15391,890,209918,2.77,0.002293544486656529,0.004257802782402287,0.0034082520992910763,6935883,32.0
2021-10-04,7612317,25781,6740491,14526,883,210801,2.77,0.0021596900965139554,0.004206404405529884,0.003398257122881887,6951292,32.0
2021-10-05,7637427,25110,6759059,18568,895,211696,2.77,0.002754695466546941,0.004245710409343406,0.003298601463916917,6970755,32.0
2021-10-06,7662560,25133,6778900,19841,929,212625,2.77,0.002935467792188229,0.0043883682261356425,0.0032907679510389976,6991525,32.0
2021-10-07,7690110,27550,6799230,20330,924,213549,2.78,0.002999011639056581,0.004345679012345728,0.0035954041469170588,7012779,31.0
2021-10-08,7717356,27246,6819796,20566,936,214485,2.78,0.00302475427364568,0.004383068991191674,0.003542992232880904,7034281,31.0
2021-10-09,7746718,29362,6840845,21049,968,215453,2.78,0.0030864559585066513,0.004513136116744754,0.0038046709261565508,7056298,31.0
2021-10-10,7775365,28647,6858119,17274,962,216415,2.78,0.0025251266473660387,0.0044650109304582575,0.003697953120276321,7074534,31.0
2021-10-11,7804774,29409,6873579,15460,957,217372,2.79,0.00225426242968374,0.00442205946907559,0.0037823304758040077,7090951,31.0
2021-10-12,7832964,28190,6894285,20706,973,218345,2.79,0.003012404454797224,0.004476197486336764,0.003611891901033948,7112630,31.0
2021-10-13,7861681,28717,6916086,21801,984,219329,2.79,0.003162184330935069,0.004506629416748621,0.003666172856150007,7135415,31.0
2021-10-14,7892980,31299,6937756,21670,985,220314,2.79,0.0031332750922992147,0.004490970186341148,0.003981209616620074,7158070,31.0
2021-10-15,7925176,32196,6960024,22268,999,221313,2.79,0.0032096833615942177,0.004534437212342368,0.004079067728538499,7181337,30.0
2021-10-16,7958384,33208,6981907,21883,1002,222315,2.79,0.0031440983536839,0.0045275243659432815,0.004190190855067444,7204222,30.0
2021-10-17,7992687,34303,7000624,18717,997,223312,2.79,0.002680786209269259,0.0044846276679486605,0.004310297165856847,7223936,30.0
2021-10-18,8027012,34325,7017055,16431,998,224310,2.79,0.002347076489181532,0.004469083613957148,0.0042945507562099925,7241365,30.0
2021-10-19,8060752,33740,7040481,23426,1015,225325,2.8,0.0033384375639067265,0.004524987740180952,0.004203307532117728,7265806,30.0
2021-10-20,8094825,34073,7065712,25231,1028,226353,2.8,0.003583704011132172,0.004562298901586548,0.0042270249723599385,7292065,30.0
2021-10-21,8131164,36339,7091607,25895,1036,227389,2.8,0.0036648818972524477,0.004576921887494256,0.004489164373534971,7318996,29.0
2021-10-22,8168305,37141,7117060,25453,1064,228453,2.8,0.0035891723836360967,0.004679206118149981,0.004567734705633875,7345513,29.0
2021-10-23,8205983,37678,7143137,26077,1075,229528,2.8,0.0036640129491671844,0.004705563069865582,0.0046127072874972965,7372665,29.0
2021-10-24,8241643,35660,7165921,22784,1072,230600,2.8,0.0031896350300995024,0.004670454149384717,0.004345609782520965,7396521,29.0
2021-10-25,8279573,37930,7186611,20690,1069,231669,2.8,0.0028872771553021264,0.004635732870771792,0.004602237684888878,7418280,29.0
2021-10-26,8316019,36446,7213584,26973,1106,232775,2.8,0.0037532294429181157,0.004774052635441173,0.004401917828371182,7446359,28.0
2021-10-27,8352601,36582,7242735,29151,1123,233898,2.8,0.0040411257427652725,0.0048244012458382715,0.0043989798484105344,7476633,28.0
2021-10-28,8392697,40096,7272053,29318,1159,235057,2.8,0.0040479183623314255,0.004955151390777068,0.004800420850942011,7507110,28.0
2021-10-29,8432546,39849,7302515,30462,1163,236220,2.8,0.004188913364630231,0.004947736081035714,0.004748056554406689,7538735,27.0
2021-10-30,8472797,40251,7331424,28909,1160,237380,2.8,0.003958773107621161,0.004910676488019572,0.004773291482785824,7568804,27.0
2021-10-31,8513790,40993,7358539,27115,1158,238538,2.8,0.003698462945261438,0.00487825427584454,0.0048381897973006635,7597077,27.0
2021-11-01,8554192,40402,7381726,23187,1155,239693,2.8,0.003151033105892376,0.004841995824564682,0.00474547763099631,7621419,27.0
2021-11-02,8593200,39008,7412631,30905,1178,240871,2.8,0.004186690213102029,0.0049146199513543385,0.0045601033972584295,7653502,27.0
2021-11-03,8633643,40443,7445438,32807,1189,242060,2.8,0.004425823975319876,0.004936252184779333,0.004706395754782822,7687498,27.0
2021-11-04,8673860,40217,7477366,31928,1195,243255,2.8,0.004288263497728373,0.004936792530777501,0.004658172685620743,7720621,26.0
2021-11-05,8714595,40735,7505971,28605,1192,244447,2.81,0.003825544984691121,0.004900207601077122,0.0046962943833541715,7750418,26.0
2021-11-06,8755930,41335,7535172,29201,1188,245635,2.81,0.0038903694138971994,0.004859949191440283,0.004743192311289279,7780807,26.0
2021-11-07,8795095,39165,7561978,26806,1179,246814,2.81,0.003557450314339184,0.0047998045881083575,0.004472968605276685,7808792,26.0
2021-11-08,8834495,39400,7587560,25582,1190,248004,2.81,0.0033829773109628203,0.004821444488562143,0.004479769689810009,7835564,26.0
2021-11-09,8873655,39160,7619596,32036,1211,249215,2.81,0.004222174190385397,0.004882985758294156,0.004432624615215763,7868811,26.0
2021-11-10,8911713,38058,7654161,34565,1239,250454,2.81,0.004536329747666379,0.004971610858094389,0.004288875328148256,7904615,26.0
2021-11-11,8952472,40759,7687317,33156,1237,251691,2.81,0.004331761508544085,0.004939030720212179,0.004573643697906249,7939008,26.0
2021-11-12,8992595,40123,7720962,33645,1235,252926,2.81,0.00437668955241466,0.004906810334894818,0.00448177888744028,7973888,26.0
2021-11-13,9031851,39256,7754764,33802,1241,254167,2.81,0.0043779518666198225,0.004906573464175335,0.0043653695067997775,8008931,26.0
2021-11-14,9070674,38823,7784585,29821,1219,255386,2.82,0.003845507097314682,0.004796059283856735,0.004298454436416188,8039971,26.0
2021-11-15,9109094,38420,7812287,27702,1211,256597,2.82,0.003558571201933036,0.00474184176109893,0.004235627914750406,8068884,26.0
2021-11-16,9145912,36818,7846448,34161,1240,257837,2.82,0.004372727218034944,0.004832480504448622,0.004041894836083637,8104285,26.0
2021-11-17,9182538,36626,7882836,36388,1247,259084,2.82,0.004637512413260048,0.00483638888134741,0.004004630702766354,8141920,26.0
2021-11-18,9219912,37374,7919250,36414,1251,260335,2.82,0.00461940347357226,0.00482854981395997,0.00407011656254519,8179585,26.0
2021-11-19,9257068,37156,7956254,37004,1254,261589,2.83,0.004672664709410634,0.004816870570610865,0.0040299733880322375,8217843,26.0
2021-11-20,9294188,37120,7992426,36172,1254,262843,2.83,0.0045463606365507845,0.004793779554950639,0.004009908969016872,8255269,26.0
2021-11-21,9331158,36970,8024930,32504,1252,264095,2.83,0.004066850290512568,0.004763299764498186,0.003977754700034142,8289025,26.0
2021-11-22,9366839,35681,8053643,28713,1241,265336,2.83,0.0035779751349855893,0.0046990666237527465,0.00382385551718234,8318979,26.0
2021-11-23,9400835,33996,8089694,36051,1243,266579,2.84,0.004476359332043822,0.004684626285162974,0.003629399416388068,8356273,26.0
2021-11-24,9434393,33558,8126376,36682,1240,267819,2.84,0.004534411313950715,0.004651529190221382,0.003569682905826932,8394195,26.0
2021-11-25,9468189,33796,8164826,38450,1238,269057,2.84,0.004731506393501839,0.004622524914214443,0.003582212443344224,8433883,26.0
2021-11-26,9502879,34690,8200971,36145,1235,270292,2.84,0.004426916140037872,0.004590105442341175,0.003663847436927936,8471263,27.0
2021-11-27,9536825,33946,8237465,36494,1239,271531,2.85,0.004449960864390422,0.004583931451911161,0.0035721805991637545,8508996,27.0
2021-11-28,9570373,33548,8268111,30646,1224,272755,2.85,0.0037203192972594663,0.004507772593184578,0.003517732578714572,8540866,27.0
2021-11-29,9604233,33860,8295811,27700,1209,273964,2.85,0.003350221108545881,0.004432549357481941,0.0035380021238462507,8569775,27.0
2021-11-30,9636881,32648,8329253,33442,1229,275193,2.86,0.0040311911638295506,0.0044859908601129215,0.0033993344393039577,8604446,27.0
2021-12-01,9669718,32837,8364932,35679,1226,276419,2.86,0.004283577410843398,0.004455055179455769,0.0034074302671165397,8641351,27.0
2021-12-02,9703107,33389,8400117,35185,1221,277640,2.86,0.004206250570835568,0.004417207210792418,0.00345294454295364,8677757,27.0
2021-12-03,9736037,32930,8436631,36514,1217,278857,2.86,0.004346844216574608,0.004383374153580144,0.0033937583085499323,8715488,27.0
2021-12-04,9769011,32974,8471813,35182,1215,280072,2.87,0.004170148012873964,0.0043570719042376185,0.0033867989614255745,8751885,28.0
2021-12-05,9801613,32602,8502406,30593,1206,281278,2.87,0.00361115147371649,0.004306035590847968,0.003337287674259004,8783684,28.0
2021-12-06,9833749,32136,8530476,28070,1184,282462,2.87,0.0033014184455553157,0.004209358712732536,0.003278644035425549,8812938,28.0
2021-12-07,9864845,31096,8565091,34615,1182,283644,2.88,0.0040578040428225215,0.004184633685239136,0.003162171416008386,8848735,28.0
2021-12-08,9895597,30752,8602067,36976,1179,284823,2.88,0.0043170586278651335,0.0041566188602615295,0.003117332304765075,8886890,28.0
2021-12-09,9925806,30209,8637861,35794,1181,286004,2.88,0.004161092909413577,0.00414643480336907,0.003052771853987224,8923865,28.0
2021-12-10,9956679,30873,8673518,35657,1176,287180,2.88,0.004127989556673707,0.004111830603767741,0.0031103771320939444,8960698,28.0
2021-12-11,9986967,30288,8709964,36446,1171,288351,2.89,0.004201985860869728,0.00407758200431796,0.0030419781535591106,8998315,28.0
2021-12-12,10016896,29929,8741355,31391,1132,289483,2.89,0.0036040332658091594,0.0039257710221223254,0.0029968057369169627,9030838,29.0
2021-12-13,10046454,29558,8769916,28561,1121,290604,2.89,0.0032673424200253547,0.003872420833002321,0.0029508143041516717,9060520,29.0
2021-12-14,10074797,28343,8804000,34084,1145,291749,2.9,0.0038864682398325186,0.003940069648043386,0.0028211944234253217,9095749,29.0
2021-12-15,10103160,28363,8839633,35633,1142,292891,2.9,0.004047364834166346,0.003914323613791293,0.002815242828217768,9132524,29.0
2021-12-16,10131646,28486,8876788,37155,1133,294024,2.9,0.00420322879920465,0.0038683332707389892,0.0028195138946627285,9170812,29.0
2021-12-17,10159389,27743,8914225,37437,1080,295104,2.9,0.004217403862748492,0.003673169537180554,0.002738252007620457,9209329,29.0
2021-12-18,10186823,27434,8952266,38041,1076,296180,2.91,0.004267448936951857,0.0036461721969203173,0.002700359244045103,9248446,29.0
2021-12-19,10214790,27967,8984921,32655,1023,297203,2.91,0.0036476798164843953,0.0034539806874198664,0.002745409437270085,9282124,29.0
2021-12-20,10241812,27022,9014980,30059,1019,298222,2.91,0.003345494078356381,0.0034286329545798466,0.0026453798854406685,9313202,29.0
2021-12-21,10267719,25907,9055199,40219,1027,299249,2.91,0.00446135210505183,0.003443743251671627,0.002529532860005679,9354448,29.0
2021-12-22,10292983,25264,9097521,42322,1020,300269,2.92,0.004673779118493204,0.0034085326935093807,0.0024605270167599174,9397790,29.0
2021-12-23,10318650,25667,9139166,41645,1002,301271,2.92,0.004577620650724422,0.003337007816324622,0.002493640570474076,9440437,28.0
2021-12-24,10343353,24703,9180379,41213,998,302269,2.92,0.004509492441651775,0.003312632148464445,0.0023940147209180478,9482648,28.0
2021-12-25,10368299,24946,9222486,42107,981,303250,2.92,0.004586629811252907,0.0032454535529611306,0.0024117904513170085,9525736,28.0
2021-12-26,10392020,23721,9259771,37285,968,304218,2.93,0.004042836172372555,0.0031920857378400225,0.0022878391142076016,9563989,28.0
2021-12-27,10415230,23210,9293486,33715,937,305155,2.93,0.003641018768174797,0.0030800281377170173,0.002233444508382476,9598641,28.0
2021-12-28,10437152,21922,9337447,43961,935,306090,2.93,0.0047303024935960725,0.003064016647277512,0.0021048022943324085,9643537,27.0
2021-12-29,10458271,21119,9380223,42776,932,307022,2.94,0.00458112372686026,0.003044856088078696,0.002023444709821298,9687245,27.0
2021-12-30,10479344,21073,9423227,43004,926,307948,2.94,0.004584539194857129,0.003016070509605173,0.0020149602166552594,9731175,27.0
2021-12-31,10499982,20638,9463919,40692,912,308860,2.94,0.0043182659188831796,0.0029615389611232783,0.0019693980844601717,9772779,26.0
2022-01-01,10519733,19751,9497063,33144,847,309707,2.94,0.0035021432453088423,0.002742342809039622,0.001881050843706156,9806770,26.0
2022-01-02,10537966,18233,9524039,26976,811,310518,2.95,0.0028404570971045646,0.002618604035427019,0.0017332188944338967,9834557,26.0
2022-01-03,10554309,16343,9548076,24037,835,311353,2.95,0.002523824188456203,0.002689055062830459,0.0015508685452201296,9859429,27.0
2022-01-04,10570212,15903,9575147,27071,834,312187,2.95,0.002835230888400986,0.0026786316496068,0.0015067779425446124,9887334,27.0
2022-01-05,10585984,15772,9600728,25581,828,313015,2.96,0.0026716038928698005,0.002652256500110584,0.0014921176604594244,9913743,27.0
2022-01-06,10601300,15316,9623677,22949,802,313817,2.96,0.0023903395659161664,0.002562177531428178,0.001446818736926092,9937494,27.0
2022-01-07,10618035,16735,9645712,22035,787,314604,2.96,0.002289665374263894,0.002507830997046101,0.001578579985473505,9960316,27.0
2022-01-08,10634603,16568,9666161,20449,796,315400,2.97,0.002120009388627775,0.002530164905722776,0.001560364040992468,9981561,28.0
2022-01-09,10650849,16246,9686912,20751,763,316163,2.97,0.002146767470560418,0.00241915028535189,0.0015276545819340461,10003075,28.0
2022-01-10,10666679,15830,9706802,19890,741,316904,2.97,0.002053285918154346,0.0023437277606803697,0.0014862664938728456,10023706,28.0
2022-01-11,10684204,17525,9732018,25216,783,317687,2.97,0.002597765978949562,0.0024707797945118237,0.0016429668503195052,10049705,28.0
2022-01-12,10702150,17946,9758364,26346,745,318432,2.98,0.002707146657558557,0.00234507549884011,0.0016796759028561148,10076796,28.0
2022-01-13,10723305,21155,9784348,25984,740,319172,2.98,0.002662741418540948,0.002323887046528084,0.0019767056152268925,10103520,28.0
2022-01-14,10747125,23820,9809300,24952,739,319911,2.98,0.0025501954754676426,0.002315366009549624,0.0022213300843350052,10129211,29.0
2022-01-15,10774304,27179,9835884,26584,723,320634,2.98,0.0027100812494265107,0.0022600035634909865,0.002528955418309442,10156518,29.0
2022-01-16,10803534,29230,9858615,22731,686,321320,2.97,0.002311027661570541,0.0021395110936457407,0.0027129362601983065,10179935,29.0
2022-01-17,10834260,30726,9878371,19756,670,321990,2.97,0.0020039326010803378,0.002085148761359345,0.002844069357304857,10200361,29.0
2022-01-18,10865512,31252,9902935,24564,688,322678,2.97,0.0024866448121860785,0.0021367123202584715,0.0028845532597518986,10225613,29.0
2022-01-19,10899411,33899,9925855,22920,698,323376,2.97,0.002314465357997397,0.002163147162186352,0.003119871387560869,10249231,29.0
2022-01-20,10938261,38850,9950333,24478,684,324060,2.96,0.0024660847856432517,0.002115184800356218,0.003564412792581129,10274393,29.0
2022-01-21,10987774,49513,9975052,24719,692,324752,2.96,0.0024842384671950324,0.0021354070233907674,0.004526587910089086,10299804,29.0
2022-01-22,11044986,57212,10000577,25525,681,325433,2.95,0.002558883903562625,0.002096984776075228,0.005206878117442138,10326010,29.0
2022-01-23,11108191,63205,10023622,23045,679,326112,2.94,0.0023043670380218373,0.0020864509745477373,0.005722506121782267,10349734,29.0
2022-01-24,11173300,65109,10045336,21714,655,326767,2.92,0.0021662828067539053,0.0020085124129134435,0.005861350421504374,10372103,29.0
2022-01-25,11241109,67809,10071740,26404,681,327448,2.91,0.0026284835071719304,0.002084053775319949,0.006068842687478204,10399188,29.0
2022-01-26,11315801,74692,10099937,28197,657,328105,2.9,0.002799615557987023,0.002006425447704574,0.0066445401427919215,10428042,29.0
2022-01-27,11404617,88816,10129691,29754,665,328770,2.88,0.002945958969843065,0.0020267902043553665,0.007848847819080573,10458461,28.0
2022-01-28,11502657,98040,10159197,29506,673,329443,2.86,0.0029128233032971185,0.002047023755208821,0.00859651841004383,10488640,28.0
2022-01-29,11615779,113122,10189207,30010,668,330111,2.84,0.0029539736260650873,0.002027664876776969,0.009834423472768085,10519318,28.0
2022-01-30,11737007,121228,10218151,28944,617,330728,2.82,0.002840652859442239,0.0018690682830926344,0.010436493325157059,10548879,27.0
2022-01-31,11861077,124070,10248281,30130,621,331349,2.79,0.0029486743736708565,0.0018776759149512488,0.010570838033921335,10579630,26.0
2022-02-01,11986913,125836,10288582,40301,663,332012,2.77,0.003932464381099621,0.0020009114257173444,0.01060915463241652,10620594,24.0
2022-02-02,12128796,141883,10337008,48426,678,332690,2.74,0.004706771059413306,0.0020420948640411662,0.0118364920142493,10669698,22.0
2022-02-03,12284564,155768,10390732,53724,667,333357,2.71,0.005197248565542267,0.002004869397937981,0.012842824629913707,10724089,20.0
2022-02-04,12452765,168201,10449181,58449,682,334039,2.68,0.005625108991358818,0.0020458547443131803,0.013692061028783842,10783220,19.0
2022-02-05,12630047,177282,10509688,60507,714,334753,2.65,0.005790597368348749,0.0021374749654980985,0.014236356343350296,10844441,18.0
2022-02-06,12810118,180071,10569271,59583,661,335414,2.62,0.005669340517054256,0.001974590220251926,0.014257349952854437,10904685,17.0
2022-02-07,12982023,171905,10624954,55683,609,336023,2.59,0.005268386059927854,0.001815666609026545,0.01341947045296532,10960977,17.0
2022-02-08,13147666,165643,10706142,81188,698,336721,2.56,0.0076412566115580125,0.0020772387604419684,0.012759413536703734,11042863,17.0
2022-02-09,13330769,183103,10803305,97163,669,337390,2.53,0.009075444730697546,0.0019868080695888413,0.013926654358271671,11140695,16.0
2022-02-10,13527845,197076,10909397,106092,701,338091,2.5,0.009820328131067368,0.002077714217967319,0.014783543244954568,11247488,15.0
2022-02-11,13731794,203949,11021633,112236,722,338813,2.47,0.010288011335548576,0.0021355197269374853,0.015076237198164309,11360446,15.0
2022-02-12,13935560,203766,11134291,112658,729,339542,2.44,0.010221534322545578,0.0021516293648708995,0.014838993360954957,11473833,15.0
2022-02-13,14133509,197949,11235859,101568,706,340248,2.41,0.009122089587922488,0.0020792714892414747,0.01420459601192925,11576107,15.0
2022-02-14,14313965,180456,11333044,97185,683,340931,2.38,0.008649538944908386,0.002007359337894643,0.012767954511508695,11673975,15.0
2022-02-15,14480596,166631,11470925,137881,704,341635,2.36,0.012166281186237304,0.0020649339602440975,0.01164114904570468,11812560,15.0
2022-02-16,14659880,179284,11643393,172468,748,342383,2.34,0.015035230375928688,0.002189471219283812,0.012380982108747496,11985776,15.0
2022-02-17,14840502,180622,11828475,185082,790,343173,2.31,0.015895881896282216,0.0023073575498784304,0.012320837551194064,12171648,14.0
2022-02-18,15020573,180071,12026844,198369,784,343957,2.29,0.016770462802685904,0.002284562013911362,0.01213375396600469,12370801,14.0
2022-02-19,15199720,179147,12217942,191098,798,344755,2.27,0.015889288993854,0.0023200574490416237,0.011926775363363395,12562697,14.0
2022-02-20,15370419,170699,12365238,147296,745,345500,2.25,0.012055712819720288,0.0021609548810024304,0.011230404244288785,12710738,14.0
2022-02-21,15522756,152337,12492732,127494,735,346235,2.23,0.010310679018066704,0.0021273516642545953,0.009911050570579729,12838967,14.0
2022-02-22,15657928,135172,12657025,164293,796,347031,2.22,0.013151086567773971,0.002299016563894529,0.008707989740996958,13004056,14.0
2022-02-23,15795570,137642,12836228,179203,785,347816,2.2,0.01415838240028755,0.0022620457538375933,0.008790562838199234,13184044,14.0
2022-02-24,15928568,132998,12972661,136433,762,348578,2.19,0.01062874545388248,0.0021908135335924057,0.008419955721762573,13321239,15.0
2022-02-25,16052028,123460,13139971,167310,787,349365,2.18,0.012897122648930727,0.0022577443212135058,0.007750853686282476,13489336,15.0
2022-02-26,16175023,122995,13321314,181343,793,350158,2.16,0.013800867597044242,0.0022698324102299328,0.0076622717079735106,13671472,15.0
2022-02-27,16291116,116093,13458910,137596,769,350927,2.15,0.010329011087044426,0.0021961514516304352,0.0071773004588617795,13809837,15.0
2022-02-28,16398036,106920,13575652,116742,733,351660,2.14,0.008673956509108072,0.0020887535014404435,0.006563086285801489,13927312,16.0
2022-03-01,16495369,97333,13748465,172813,786,352446,2.14,0.012729628013446348,0.002235113461866556,0.005935649854653224,14100911,16.0
2022-03-02,16592824,97455,13931995,183530,784,353230,2.13,0.013349126611589046,0.002224454242635732,0.005908021821154685,14285225,16.0
2022-03-03,16685850,93026,14102684,170689,781,354011,2.12,0.012251583495400231,0.0022110239787107573,0.005606399489321401,14456695,16.0
2022-03-04,16775024,89174,14263191,160507,776,354787,2.11,0.011381308692728355,0.002192022281793493,0.005344288723678981,14617978,16.0
2022-03-05,16861793,86769,14418916,155725,750,355537,2.11,0.010917963588933157,0.0021139444229918425,0.005172511228597854,14774453,16.0
2022-03-06,16941656,79863,14567976,149060,744,356281,2.1,0.01033780902808501,0.002092609208043106,0.004736329048755428,14924257,16.0
2022-03-07,17014818,73162,14690595,122619,671,356952,2.1,0.008417023751274622,0.0018833448878834427,0.004318468041140777,15047547,16.0
2022-03-08,17081394,66576,14802351,111756,649,357601,2.09,0.007607316109388362,0.001818171630919574,0.003912824691983285,15159952,17.0
2022-03-09,17140069,58675,14895083,92732,645,358246,2.09,0.0062646805227088995,0.001803686231302448,0.0034350240969793773,15253329,17.0
2022-03-10,17191300,51231,15043717,148634,665,358911,2.09,0.009978729222254179,0.001856266364453463,0.0029889611296196605,15402628,17.0
2022-03-11,17242043,50743,15194927,151210,674,359585,2.09,0.010051372277210424,0.0018779028784294829,0.002951667413168213,15554512,17.0
2022-03-12,17290197,48154,15351778,156851,630,360215,2.08,0.01032258990122159,0.0017520196893641151,0.00279282449301399,15711993,17.0
2022-03-13,17335186,44989,15480407,128629,596,360811,2.08,0.008378768895694,0.0016545674111294595,0.002601994644711114,15841218,17.0
2022-03-14,17376241,41055,15585650,105243,533,361344,2.08,0.006798464665690007,0.0014772276898431524,0.002368304556986001,15946994,17.0
2022-03-15,17412919,36678,15704022,118372,558,361902,2.08,0.0075949350845168065,0.0015442348565355426,0.0021108132650784484,16065924,17.0
2022-03-16,17449438,36519,15822031,118009,576,362478,2.08,0.007514571744741572,0.0015915910937214226,0.00209723596600897,16184509,17.0
2022-03-17,17484257,34819,15934645,112614,561,363039,2.08,0.00711754388548469,0.0015476801350702285,0.0019954224313700752,16297684,17.0
2022-03-18,17518699,34442,16039709,105064,524,363563,2.08,0.006593432109720743,0.0014433710978709602,0.001969886395515763,16403272,17.0
2022-03-19,17551657,32958,16135267,95558,495,364058,2.07,0.005957589380206407,0.001361524687605753,0.0018813040854233078,16499325,17.0
2022-03-20,17582692,31035,16209942,74675,434,364492,2.07,0.004628061004506412,0.0011921177394811355,0.001768209121224329,16574434,18.0
2022-03-21,17611401,28709,16271880,61938,409,364901,2.07,0.0038209883786135546,0.0011221096759326254,0.0016327988910913582,16636781,18.0
2022-03-22,17637795,26394,16346800,74920,472,365373,2.07,0.004604262076662424,0.0012935015250712392,0.0014986882644940636,16712173,18.0
2022-03-23,17664621,26826,16417422,70622,429,365802,2.07,0.004320233929576478,0.0011741425885327672,0.0015209384166217088,16783224,18.0
2022-03-24,17690008,25387,16483898,66476,418,366220,2.07,0.004049113192071241,0.001142694681822487,0.00143716641302416,16850118,19.0
2022-03-25,17715390,25382,16545758,61860,398,366618,2.07,0.0037527531412775428,0.001086778439189473,0.001434821284422183,16912376,19.0
2022-03-26,17739462,24072,16606691,60933,395,367013,2.07,0.003682696193187507,0.0010774157297241962,0.001358818518813365,16973704,19.0
2022-03-27,17762742,23280,16654231,47540,338,367351,2.07,0.002862701546021418,0.0009209483042835752,0.001312328412214514,17021582,19.0
2022-03-28,17783843,21101,16689977,35746,335,367686,2.07,0.0021463614861592095,0.0009119343625034748,0.0011879359616888685,17057663,20.0
2022-03-29,17803503,19660,16737206,47229,339,368025,2.07,0.002829782210005405,0.0009219823436301676,0.0011054978386841883,17105231,20.0
2022-03-30,17823648,20145,16788291,51085,352,368377,2.07,0.003052182066708209,0.0009564567624482656,0.0011315188926583895,17156668,20.0
2022-03-31,17842925,19277,16838787,50496,345,368722,2.07,0.003007810622296159,0.0009365405549206508,0.0010815406587922904,17207509,20.0
2022-04-01,17862089,19164,16884785,45998,342,369064,2.07,0.0027316694486365645,0.0009275280563676436,0.0010740391499712842,17253849,20.0
2022-04-02,17880038,17949,16929332,44547,340,369404,2.07,0.002638292403486231,0.0009212494309929207,0.0010048656682877244,17298736,20.0
2022-04-03,17896866,16828,16965027,35695,304,369708,2.07,0.00210847067090425,0.0008229472339227327,0.0009411613107310756,17334735,21.0
2022-04-04,17912157,15291,16997877,32850,287,369995,2.07,0.0019363364408437886,0.0007762883140207678,0.0008543954008484178,17367872,21.0
2022-04-05,17926104,13947,17035336,37459,316,370311,2.07,0.0022037457971957326,0.0008540655954809572,0.0007786331930879076,17405647,21.0
2022-04-06,17940765,14661,17070642,35306,291,370602,2.07,0.0020725156228207364,0.0007858259679025537,0.0008178575779766994,17441244,21.0
2022-04-07,17955120,14355,17105946,35304,287,370889,2.07,0.002068112025312318,0.0007744156804334602,0.000800133104692069,17476835,21.0
2022-04-08,17969431,14311,17143630,37684,280,371169,2.07,0.0022029766725557565,0.0007549428535222892,0.0007970428490591264,17514799,21.0
2022-04-09,17983004,13573,17183730,40100,288,371457,2.07,0.0023390612139901896,0.0007759268688927179,0.0007553383298557481,17555187,20.0
2022-04-10,17996060,13056,17213102,29372,259,371716,2.07,0.0017092912889111744,0.0006972543255343577,0.0007260188564712777,17584818,20.0
2022-04-11,18007915,11855,17239857,26755,248,371964,2.07,0.0015543392469294925,0.0006671760160983363,0.000658755305327885,17611821,20.0
2022-04-12,18018825,10910,17271128,31271,281,372245,2.07,0.001813878154557802,0.0007554494520976008,0.0006058447077299522,17643373,20.0
2022-04-13,18030579,11754,17299263,28135,267,372512,2.07,0.0016290192510877155,0.0007172695402222207,0.0006523177843171801,17671775,20.0
2022-04-14,18041927,11348,17321116,21853,254,372766,2.07,0.0012632330059378913,0.0006818572287603518,0.0006293752408061959,17693882,20.0
2022-04-15,18053359,11432,17340639,19523,261,373027,2.07,0.0011271213702397365,0.0007001711529484034,0.0006336351987235034,17713666,21.0
2022-04-16,18064454,11095,17359645,19006,240,373267,2.07,0.0010960380410434123,0.0006433850632796556,0.0006145670730859365,17732912,21.0
2022-04-17,18074717,10263,17376141,16496,233,373500,2.07,0.0009502498466991137,0.0006242180530291462,0.0005681323111121905,17749641,21.0
2022-04-18,18084151,9434,17390465,14324,213,373713,2.07,0.0008243487434869133,0.0005702811244980843,0.0005219445482880225,17764178,21.0
2022-04-19,18092791,8640,17407228,16763,235,373948,2.07,0.0009639190211416793,0.0006288247933574631,0.0004777664154651528,17781176,22.0
2022-04-20,18101986,9195,17423428,16200,223,374171,2.07,0.0009306478894859359,0.00059633959801908,0.0005082134646887669,17797599,22.0
2022-04-21,18110861,8875,17437610,14182,197,374368,2.07,0.0008139615235303044,0.0005264972432390547,0.0004902776966018152,17811978,22.0
2022-04-22,18119862,9001,17451090,13480,195,374563,2.07,0.0007730417184466097,0.0005208778528078549,0.0004969945934651944,17825653,22.0
2022-04-23,18128691,8829,17464120,13030,171,374734,2.07,0.0007466582316635327,0.0004565320119713778,0.0004872553665142832,17838854,23.0
2022-04-24,18137137,8446,17474628,10508,168,374902,2.07,0.0006016907808694683,0.00044831800690614543,0.0004658913321431424,17849530,23.0
2022-04-25,18144788,7651,17483483,8855,159,375061,2.07,0.0005067346784148885,0.0004241108342979416,0.0004218416611176945,17858544,24.0
2022-04-26,18151895,7107,17495382,11899,176,375237,2.07,0.0006805852129121438,0.0004692570008610896,0.0003916827245378229,17870619,24.0
2022-04-27,18159600,7705,17506859,11477,163,375400,2.07,0.0006560016809007418,0.00043439213084006667,0.0004244735880192252,17882259,24.0
2022-04-28,18167281,7681,17517922,11063,166,375566,2.07,0.000631923750571195,0.00044219499200859325,0.0004229718716270981,17893488,25.0
2022-04-29,18174991,7710,17528963,11041,161,375727,2.07,0.0006302688184134375,0.0004286863028069022,0.00042438931835753197,17904690,25.0
2022-04-30,18182354,7363,17539985,11022,157,375884,2.07,0.000628787909473072,0.00041785658203963294,0.00040511711945279133,17915869,25.0
2022-05-01,18189401,7047,17548718,8733,147,376031,2.07,0.0004978909617083803,0.0003910780985623141,0.0003875735782066237,17924749,26.0
2022-05-02,18195608,6207,17556220,7502,136,376167,2.07,0.0004274956153491605,0.0003616723089319152,0.0003412426830329274,17932387,26.0
2022-05-03,18201074,5466,17563272,7052,125,376292,2.07,0.00040168099966853,0.00033229921816646524,0.0003004021629835485,17939564,27.0
2022-05-04,18206167,5093,17569936,6664,129,376421,2.07,0.0003794281612219397,0.00034281887470366534,0.00027981865245974014,17946357,27.0
2022-05-05,18211178,5011,17578659,8723,139,376560,2.07,0.0004964730662651019,0.0003692673894388765,0.0002752364075315761,17955219,27.0
2022-05-06,18216719,5541,17588067,9408,136,376696,2.07,0.0005351944081741777,0.000361164223496857,0.00030426367805524984,17964763,28.0
2022-05-07,18222219,5500,17596716,8649,132,376828,2.07,0.0004917538692568169,0.0003504151889055507,0.0003019204501095718,17973544,28.0
2022-05-08,18227666,5447,17603398,6682,118,376946,2.07,0.000379729945064744,0.0003131402125107208,0.0002989207845651709,17980344,29.0
2022-05-09,18232696,5030,17609357,5959,103,377049,2.07,0.0003385141891354415,0.00027324868814093684,0.00027595414574754784,17986406,29.0
2022-05-10,18237227,4531,17614371,5014,101,377150,2.07,0.0002847349849286473,0.00026786969332892596,0.00024850960055489146,17991521,30.0
2022-05-11,18241329,4102,17619414,5043,98,377248,2.07,0.00028630031693999136,0.0002598435635687846,0.00022492454582057064,17996662,30.0
2022-05-12,18245394,4065,17626344,6930,111,377359,2.07,0.00039331614547455374,0.00029423615234547285,0.00022284560516405702,18003703,31.0
2022-05-13,18250290,4896,17633601,7257,105,377464,2.07,0.0004117132855230299,0.0002782496243629584,0.0002683416976361208,18011065,31.0
2022-05-14,18255337,5047,17640979,7378,107,377571,2.07,0.0004184057470735248,0.0002834707415806381,0.0002765435508147452,18018550,32.0
2022-05-15,18260293,4956,17647179,6200,99,377670,2.07,0.00035145441758088763,0.00026220234075191584,0.0002714822520120119,18024849,32.0
2022-05-16,18264836,4543,17652558,5379,89,377759,2.07,0.0003048079242580215,0.00023565546641246549,0.00024879118861886873,18030317,33.0
2022-05-17,18268958,4122,17658542,5984,110,377869,2.07,0.0003389876979869033,0.0002911909444911487,0.00022567955168062423,18036411,33.0
2022-05-18,18273690,4732,17664676,6134,106,377975,2.07,0.0003473672968017372,0.00028052049784443867,0.00025901860412624883,18042651,33.0
2022-05-19,18278617,4927,17670628,5952,97,378072,2.07,0.00033694362693093005,0.00025663072954551497,0.0002696226104306198,18048700,34.0
2022-05-20,18283706,5089,17676801,6173,96,378168,2.07,0.000349336763809438,0.000253919888275167,0.0002784127486230581,18054969,34.0
2022-05-21,18288740,5034,17683089,6288,102,378270,2.07,0.00035572047227327985,0.00026972139366621134,0.0002753271136606284,18061359,35.0
2022-05-22,18293450,4710,17688903,5814,80,378350,2.07,0.000328788708805261,0.00021148914796298435,0.0002575355109208921,18067253,35.0
2022-05-23,18297608,4158,17694020,5117,76,378426,2.07,0.0002892774074232385,0.00020087220827269547,0.00022729446878533285,18072446,36.0
2022-05-24,18301393,3785,17700372,6352,90,378516,2.07,0.00035899134283789985,0.00023782721060383594,0.0002068576395339861,18078888,36.0
2022-05-25,18305973,4580,17707077,6705,93,378609,2.07,0.0003788055979840888,0.00024569635101290293,0.0002502541746411957,18085686,36.0
2022-05-26,18310673,4700,17713532,6455,91,378700,2.07,0.00036454350991976803,0.00024035350453899262,0.0002567468006207108,18092232,37.0
2022-05-27,18315292,4619,17719596,6064,84,378784,2.07,0.00034233714653852937,0.0002218114602587917,0.0002522572490917252,18098380,37.0
2022-05-28,18319848,4556,17725440,5844,86,378870,2.07,0.00032980435897078664,0.0002270423249133291,0.00024875388282108446,18104310,37.0
2022-05-29,18324036,4188,17729851,4411,85,378955,2.07,0.00024885136842867084,0.0002243513606250413,0.00022860451680606358,18108806,38.0
2022-05-30,18327837,3801,17733870,4019,74,379029,2.07,0.00022667985196256343,0.00019527384517958882,0.0002074324673886352,18112899,38.0
2022-05-31,18331363,3526,17739356,5486,88,379117,2.07,0.000309351540301206,0.0002321722084590583,0.00019238494973516929,18118473,39.0
2022-06-01,18335514,4151,17744984,5628,83,379200,2.07,0.00031726067169524086,0.00021892977629600632,0.00022644251821324346,18124184,39.0
2022-06-02,18339776,4262,17749960,4976,85,379285,2.07,0.0002804172717203457,0.00022415611814352587,0.0002324450789872312,18129245,39.0
2022-06-03,18343964,4188,17755194,5234,78,379363,2.07,0.00029487390394122853,0.00020565010480244617,0.00022835611514548937,18134557,40.0
2022-06-04,18348065,4101,17760326,5132,82,379445,2.07,0.0002890421811216904,0.0002161518123802164,0.00022356127606881768,18139771,40.0
2022-06-05,18351851,3786,17764261,3935,75,379520,2.07,0.00022156124836891777,0.0001976571044552955,0.00020634328470059413,18143781,41.0
2022-06-06,18355200,3349,17767753,3492,64,379584,2.07,0.00019657445924714523,0.0001686340640809636,0.00018248840403067845,18147337,41.0
2022-06-07,18358459,3259,17772888,5135,73,379657,2.07,0.00028900671908260733,0.00019231579834766419,0.00017755186541146273,18152545,41.0
2022-06-08,18362105,3646,17777625,4737,79,379736,2.07,0.00026652955895523084,0.00020808255873072667,0.00019860054702847132,18157361,42.0
2022-06-09,18365879,3774,17781922,4297,77,379813,2.07,0.00024170832718084512,0.0002027724524407137,0.00020553199102169017,18161735,42.0
2022-06-10,18369557,3678,17786254,4332,70,379883,2.07,0.00024361820955021152,0.00018430122191714918,0.0002002626718820011,18166137,43.0
2022-06-11,18373184,3627,17791081,4827,72,379955,2.07,0.00027138935494797073,0.0001895320401281708,0.00019744624217121756,18171036,43.0
2022-06-12,18376587,3403,17794561,3480,65,380020,2.07,0.00019560362858217492,0.00017107289021067726,0.0001852155837551717,18174581,44.0
2022-06-13,18379583,2996,17798245,3684,56,380076,2.07,0.00020702955245699428,0.00014736066522824662,0.00016303353827340494,18178321,44.0
2022-06-14,18382380,2797,17801569,3324,61,380137,2.07,0.00018675998672912364,0.00016049421694619426,0.00015217973117231942,18181706,45.0
2022-06-15,18385098,2718,17806097,4528,66,380203,2.07,0.0002543596016733041,0.00017362161536493836,0.00014785898235158967,18186300,45.0
2022-06-16,18388424,3326,17810796,4699,67,380270,2.07,0.000263898371439808,0.00017622165001318635,0.00018090738488307775,18191066,45.0
2022-06-17,18391797,3373,17815024,4228,63,380333,2.07,0.00023738411242257842,0.0001656717595392987,0.00018343061917658327,18195357,46.0
2022-06-18,18395179,3382,17819395,4371,68,380401,2.07,0.00024535470735265186,0.00017879069131532255,0.00018388632714905206,18199796,46.0
2022-06-19,18398260,3081,17822674,3279,62,380463,2.07,0.00018401298136105915,0.00016298590171959226,0.0001674895362528961,18203137,46.0
2022-06-20,18400927,2667,17825397,2723,54,380517,2.07,0.00015278291012887912,0.0001419323298192943,0.00014495936028735557,18205914,47.0
2022-06-21,18403427,2500,17828837,3440,60,380577,2.07,0.00019298307914272783,0.00015768020876860692,0.0001358627203944529,18209414,47.0
2022-06-22,18406485,3058,17832604,3767,66,380643,2.07,0.00021128691680782907,0.00017342088460425842,0.0001661647039978842,18213247,47.0
2022-06-23,18409651,3166,17836121,3517,68,380711,2.07,0.00019722301913960294,0.00017864508213727426,0.00017200459511967914,18216832,47.0
2022-06-24,18412805,3154,17839346,3225,65,380776,2.07,0.00018081285723514642,0.00017073318081162192,0.00017132318260681956,18220122,48.0
2022-06-25,18415877,3072,17842800,3454,61,380837,2.07,0.0001936169633125484,0.00016019917221665736,0.0001668404135057866,18223637,48.0
2022-06-26,18418881,3004,17845513,2713,55,380892,2.07,0.0001520501266616403,0.0001444187408261577,0.0001631201164082885,18226405,49.0
2022-06-27,18421564,2683,17847868,2355,51,380943,2.07,0.00013196594572550957,0.0001338962225512219,0.00014566574375507457,18228811,49.0
2022-06-28,18424105,2541,17851282,3414,59,381002,2.07,0.00019128335104223734,0.00015487881389075753,0.0001379361708919724,18232284,50.0
2022-06-29,18427133,3028,17854962,3680,54,381056,2.07,0.00020614765931092902,0.00014173153946694939,0.0001643499100769663,18236018,50.0
2022-06-30,18430239,3106,17858217,3255,56,381112,2.07,0.00018230226421089848,0.00014696002687264453,0.00016855579215713234,18239329,50.0
2022-07-01,18433394,3155,17861605,3388,53,381165,2.07,0.00018971658816768766,0.00013906673103969425,0.00017118606003974082,18242770,50.0
2022-07-02,18436679,3285,17865093,3488,51,381216,2.07,0.00019527920363260345,0.00013380032269494355,0.00017820917840749573,18246309,50.0
2022-07-03,18439759,3080,17867688,2595,47,381263,2.07,0.00014525533116449552,0.00012328968353902958,0.00016705828636487394,18248951,51.0
2022-07-04,18442625,2866,17869964,2276,43,381306,2.07,0.00012738077808394088,0.0001127830395291074,0.000155425024806366,18251270,51.0
2022-07-05,18445301,2676,17873576,3612,48,381354,2.07,0.00020212687613696542,0.0001258831489669987,0.00014509865054468385,18254930,52.0
2022-07-06,18448451,3150,17877013,3437,44,381398,2.07,0.00019229503933626543,0.000115378362361529,0.0001707752017710007,18258411,52.0
2022-07-07,18451810,3359,17880191,3178,52,381450,2.07,0.00017777019013176518,0.00013634051568178762,0.00018207490699362341,18261641,52.0
2022-07-08,18455274,3464,17882978,2787,49,381499,2.07,0.00015587081815837678,0.00012845720277887549,0.00018773226041246535,18264477,53.0
2022-07-09,18458813,3539,17886064,3086,45,381544,2.07,0.00017256633654638698,0.00011795574824580156,0.00019176090260164536,18267608,53.0
2022-07-10,18462211,3398,17888560,2496,39,381583,2.07,0.00013954998707377264,0.00010221625815098888,0.00018408550972370816,18270143,53.0
2022-07-11,18465308,3097,17890856,2296,38,381621,2.07,0.00012835018581713878,9.958514923358308e-05,0.00016774805574470977,18272477,54.0
2022-07-12,18468310,3002,17894065,3209,48,381669,2.07,0.00017936536966156602,0.00012577924170842358,0.00016257513819972758,18275734,54.0
2022-07-13,18472239,3929,17897428,3363,42,381711,2.07,0.00018793940896055797,0.0001100429953704296,0.00021274280104677248,18279139,54.0
2022-07-14,18476477,4238,17900518,3090,43,381754,2.07,0.0001726505059833627,0.00011265067027155241,0.00022942535552950005,18282272,55.0
2022-07-15,18480934,4457,17903447,2929,40,381794,2.07,0.00016362654980150992,0.00010477951769982674,0.00024122564058082216,18285241,55.0
2022-07-16,18485632,4698,17906326,2879,41,381835,2.07,0.00016080702224541277,0.00010738775360530363,0.0002542079312657375,18288161,56.0
2022-07-17,18490296,4664,17908809,2483,46,381881,2.07,0.00013866607812240694,0.0001204708840205626,0.00025230405971510267,18290690,56.0
2022-07-18,18494844,4548,17911340,2531,35,381916,2.06,0.00014132709774283822,9.165158779822491e-05,0.000245966857426172,18293256,57.0
2022-07-19,18499044,4200,17915526,4186,44,381960,2.06,0.00023370669084510356,0.00011520857989721911,0.00022709031771239732,18297486,57.0
2022-07-20,18504729,5685,17919843,4317,37,381997,2.06,0.00024096417822172533,9.686878207149086e-05,0.0003073131779134375,18301840,56.0
2022-07-21,18511120,6391,17924372,4529,42,382039,2.06,0.000252736589265945,0.00010994850744894258,0.0003453711751195687,18306411,56.0
2022-07-22,18517779,6659,17929059,4687,41,382080,2.06,0.00026148754332933066,0.00010731888629167409,0.0003597297192174942,18311139,56.0
2022-07-23,18524732,6953,17933862,4803,38,382118,2.06,0.0002678891290390784,9.945561139024228e-05,0.0003754769942982961,18315980,56.0
2022-07-24,18532255,7523,17938674,4812,37,382155,2.06,0.00026831922761538785,9.682872829852585e-05,0.0004061057401532064,18320829,56.0
2022-07-25,18538826,6571,17942908,4234,34,382189,2.06,0.00023602636404462807,8.896913556011299e-05,0.0003545709898769012,18325097,56.0
2022-07-26,18545009,6183,17948330,5422,47,382236,2.06,0.0003021806721630327,0.00012297580516440476,0.00033351626472999385,18330566,56.0
2022-07-27,18554036,9027,17953445,5115,36,382272,2.06,0.00028498473116989054,9.418265155547444e-05,0.0004867616942110242,18335717,55.0
2022-07-28,18565551,11515,17958463,5018,41,382313,2.06,0.00027950067521853583,0.00010725347396611795,0.0006206196861966441,18340776,55.0
2022-07-29,18576973,11422,17963133,4670,39,382352,2.06,0.00026004452608230366,0.00010201065618997697,0.0006152254786297995,18345485,55.0
2022-07-30,18589221,12248,17969342,6209,43,382395,2.06,0.000345652398164642,0.00011246181529056543,0.0006593108575869699,18351737,55.0
2022-07-31,18601719,12498,17975398,6056,38,382433,2.06,0.00033701846177791595,9.937368427936909e-05,0.0006723251071145686,18357831,54.0
2022-08-01,18612543,10824,17981475,6077,36,382469,2.05,0.00033807318202350167,9.413413591397024e-05,0.000581881706739118,18363944,53.0
2022-08-02,18622103,9560,17990048,8573,48,382517,2.05,0.000476768451976195,0.0001255003673499289,0.0005136321243153219,18372565,52.0
2022-08-03,18636741,14638,18000314,10266,43,382560,2.05,0.00057064883873581,0.00011241330450673102,0.0007860551517731017,18382874,49.0
2022-08-04,18653867,17126,18010066,9752,44,382604,2.05,0.0005417683269302033,0.00011501463822671809,0.0009189374901974466,18392670,47.0
2022-08-05,18672422,18555,18019883,9817,47,382651,2.05,0.0005450840657663658,0.0001228424167023512,0.0009946999193251036,18402534,45.0
2022-08-06,18692396,19974,18030626,10743,46,382697,2.05,0.0005961747920339987,0.00012021398088601921,0.001069705901034057,18413323,42.0
2022-08-07,18712699,20303,18039355,8729,44,382741,2.05,0.0004841207399011172,0.00011497346464706125,0.0010861635929391156,18422096,40.0
2022-08-08,18730561,17862,18048076,8721,45,382786,2.04,0.00048344300558422765,0.00011757298016146223,0.0009545389470539957,18430862,38.0
2022-08-09,18746886,16325,18061168,13092,60,382846,2.04,0.0007253958815331972,0.00015674554450795242,0.0008715702642327905,18444014,35.0
2022-08-10,18770657,23771,18075720,14552,56,382902,2.04,0.0008057064747972742,0.0001462729139132257,0.0012679972556508545,18458622,32.0
2022-08-11,18796472,25815,18089941,14221,52,382954,2.04,0.0007867459774770769,0.00013580498404297536,0.0013752848395236494,18472895,28.0
2022-08-12,18824282,27810,18104261,14320,57,383011,2.03,0.0007916001494974179,0.00014884294197203832,0.0014795329676760005,18487272,26.0
2022-08-13,18852976,28694,18121135,16874,60,383071,2.03,0.000932045776405932,0.00015665346426074755,0.0015243078062685544,18504206,24.0
2022-08-14,18881958,28982,18136077,14942,54,383125,2.03,0.0008245620376428063,0.00014096603501689842,0.0015372639311692635,18519202,22.0
2022-08-15,18907231,25273,18151487,15410,53,383178,2.03,0.0008496876143611054,0.0001383360522022592,0.0013384734782271313,18534665,21.0
2022-08-16,18931140,23909,18172070,20583,59,383237,2.02,0.0011339566835488757,0.00015397543700323982,0.0012645426503754553,18555307,19.0
2022-08-17,18964246,33106,18194750,22680,63,383300,2.02,0.0012480691522760436,0.00016438913779204256,0.001748758923128868,18578050,18.0
2022-08-18,19000055,35809,18216241,21491,62,383362,2.02,0.001181164896467468,0.00016175319593014767,0.0018882374759323641,18599603,18.0
2022-08-19,19037664,37609,18238128,21887,65,383427,2.01,0.001201510234740466,0.00016955253781025803,0.0019794153227450373,18621555,17.0
2022-08-20,19077674,40010,18262350,24222,69,383496,2.01,0.001328096830990555,0.00017995602813569708,0.0021016233924497922,18645846,16.0
2022-08-21,19117343,39669,18284586,22236,64,383560,2.01,0.0012175870027679725,0.0001668857041534633,0.0020793415381770157,18668146,16.0
2022-08-22,19150404,33061,18306867,22281,57,383617,2.0,0.0012185673769151695,0.00014860777974767814,0.0017293721203830434,18690484,16.0
2022-08-23,19181371,30967,18337736,30869,69,383686,2.0,0.0016861978622557672,0.00017986689849514015,0.0016170416039265054,18721422,15.0
2022-08-24,19221602,40231,18370612,32876,72,383758,2.0,0.0017928058294656157,0.0001876534457863066,0.002097399607150052,18754370,14.0
2022-08-25,19265521,43919,18401387,30775,71,383829,1.99,0.0016752299814508653,0.00018501242970825338,0.0022848771918178024,18785216,14.0
2022-08-26,19311973,46452,18435096,33709,81,383910,1.99,0.0018318727821984293,0.00021103147495371569,0.002411146835842093,18819006,14.0
2022-08-27,19359066,47093,18467738,32642,90,384000,1.98,0.0017706444273466462,0.00023442994451827734,0.0024385390348256038,18851738,14.0
2022-08-28,19405923,46857,18495961,28223,83,384083,1.98,0.0015282326400776205,0.0002161458333334032,0.0024204163568635195,18880044,14.0
2022-08-29,19445581,39658,18520851,24890,77,384160,1.98,0.0013456992042748528,0.00020047750095675282,0.0020436028732051525,18905011,14.0
2022-08-30,19482648,37067,18557580,36729,94,384254,1.97,0.0019831162185797173,0.00024468971261981665,0.001906191437530236,18941834,13.0
2022-08-31,19528969,46321,18596634,39054,92,384346,1.97,0.0021044769846068068,0.00023942496369588892,0.002377551552540602,18980980,13.0
2022-09-01,19578730,49761,18635574,38940,95,384441,1.96,0.002093927320395705,0.00024717312005329006,0.0025480607808840983,19020015,13.0
2022-09-02,19629682,50952,18672586,37012,91,384532,1.96,0.001986093908349807,0.00023670732310021592,0.0026024159891882004,19057118,13.0
2022-09-03,19681381,51699,18710966,38380,92,384624,1.95,0.002055419640321965,0.00023925186980533478,0.002633715614954957,19095590,13.0
2022-09-04,19729423,48042,18746698,35732,87,384711,1.95,0.0019096822686759387,0.00022619493323339238,0.002440987245762916,19131409,13.0
2022-09-05,19771113,41690,18777401,30703,76,384787,1.95,0.0016377817576194165,0.00019755088884898517,0.002113087645796874,19162188,13.0
2022-09-06,19809613,38500,18823705,46304,95,384882,1.94,0.002465942970488744,0.00024688983775433826,0.0019472854158488762,19208587,13.0
2022-09-07,19857571,47958,18876316,52611,94,384976,1.94,0.002794933303512881,0.0002442306992793686,0.0024209458306934106,19261292,13.0
2022-09-08,19908189,50618,18926609,50293,93,385069,1.93,0.002664344038317612,0.00024157350068576558,0.00254905295315333,19311678,13.0
2022-09-09,19960295,52106,18977695,51086,96,385165,1.93,0.0026991628558501453,0.00024930596854066955,0.002617314914983071,19362860,12.0
2022-09-10,20013781,53486,19023718,46023,97,385262,1.92,0.002425110109525841,0.0002518401204678611,0.002679619715039383,19408980,12.0
2022-09-11,20066610,52829,19061006,37288,86,385348,1.92,0.0019600795175791497,0.00022322471460989315,0.0026396311621477157,19446354,12.0
2022-09-12,20113098,46488,19096666,35660,81,385429,1.92,0.0018708351489946649,0.00021019961177959343,0.002316684282995585,19482095,13.0
2022-09-13,20157143,44045,19144853,48187,101,385530,1.91,0.0025233200392151822,0.00026204566859266976,0.0021898665237944925,19530383,12.0
2022-09-14,20208878,51735,19195104,50251,98,385628,1.91,0.002624778576257647,0.0002541955230461745,0.002566583964801028,19580732,12.0
2022-09-15,20265004,56126,19244856,49752,99,385727,1.9,0.002591910937288944,0.000256724096797889,0.0027772942169277393,19630583,12.0
2022-09-16,20324039,59035,19294876,50020,110,385837,1.9,0.0025991361016159953,0.0002851757849462455,0.0029131501775179203,19680713,13.0
2022-09-17,20382344,58305,19344838,49962,107,385944,1.89,0.0025893921266972875,0.00027731917882412027,0.0028687703266068176,19730782,12.0
2022-09-18,20439095,56751,19387036,42198,101,386045,1.89,0.002181357114492189,0.00026169599734671145,0.002784321567725456,19773081,12.0
2022-09-19,20488583,49488,19425631,38595,91,386136,1.88,0.0019907633121432067,0.00023572381458114575,0.0024212422321046034,19811767,12.0
2022-09-20,20535057,46474,19477825,52194,98,386234,1.88,0.002686862527142564,0.00025379658980262404,0.002268287660498469,19864059,12.0
2022-09-21,20588102,53045,19537543,59718,107,386341,1.88,0.0030659480717174503,0.0002770341295690315,0.002583143548128497,19923884,12.0
2022-09-22,20641559,53457,19594562,57019,106,386447,1.87,0.002918432476386679,0.00027436901597299723,0.0025964996676235423,19981009,12.0
2022-09-23,20694894,53335,19652187,57625,104,386551,1.87,0.002940866960945643,0.000269118404334856,0.0025838649105913714,20038738,12.0
2022-09-24,20746163,51269,19710599,58412,111,386662,1.86,0.002972290056063587,0.00028715486442920657,0.002477374370702279,20097261,12.0
2022-09-25,20792921,46758,19756507,45908,95,386757,1.86,0.0023291022256604066,0.0002456926204281729,0.002253814355936523,20143264,12.0
2022-09-26,20833109,40188,19800764,44257,85,386842,1.86,0.002240122709950665,0.00021977624192959236,0.001932773177948377,20187606,12.0
2022-09-27,20869714,36605,19860311,59547,101,386943,1.85,0.003007308202855219,0.0002610885064187052,0.0017570589200104347,20247254,12.0
2022-09-28,20909731,40017,19921826,61515,111,387054,1.85,0.003097383520328512,0.00028686395670685094,0.0019174675800539556,20308880,12.0
2022-09-29,20948470,38739,19979763,57937,109,387163,1.85,0.0029082173491525865,0.0002816144517301389,0.001852678066494473,20366926,12.0
2022-09-30,20985756,37286,20040988,61225,106,387269,1.85,0.0030643506632186397,0.0002737864930275613,0.0017798913238054046,20428257,12.0
2022-10-01,21018942,33186,20093616,52628,103,387372,1.84,0.002626018238222505,0.00026596500107167737,0.001581358327048088,20480988,12.0
2022-10-02,21049027,30085,20140608,46992,96,387468,1.84,0.002338653231951815,0.00024782379728005566,0.0014313279897721909,20528076,12.0
2022-10-03,21073185,24158,20175902,35294,91,387559,1.84,0.0017523800671757073,0.00023485810441115082,0.0011477015065826102,20563461,12.0
2022-10-04,21094872,21687,20221339,45437,107,387666,1.84,0.0022520430561170372,0.00027608699578651747,0.0010291277754168604,20609005,12.0
2022-10-05,21118629,23757,20266033,44694,113,387779,1.84,0.002210239391169821,0.00029148803351342073,0.0011261978740615408,20653812,12.0
2022-10-06,21141674,23045,20307569,41536,108,387887,1.83,0.0020495377659752734,0.00027850915083083017,0.0010912166694154737,20695456,12.0
2022-10-07,21163942,22268,20347142,39573,104,387991,1.83,0.0019486822868852727,0.00026811932341130884,0.001053275156924549,20735133,13.0
2022-10-08,21184513,20571,20385431,38289,106,388097,1.83,0.0018817876240309066,0.00027320221345350504,0.0009719833857038117,20773528,13.0
2022-10-09,21203332,18819,20414224,28793,102,388199,1.83,0.001412430279251975,0.00026282089271489895,0.0008883376266426436,20802423,13.0
2022-10-10,21218993,15661,20439043,24819,96,388295,1.83,0.0012157699455046524,0.0002472958456873897,0.000738610327848388,20827338,14.0
2022-10-11,21232963,13970,20470552,31509,109,388404,1.83,0.0015416083815666948,0.0002807144052845434,0.000658372430774712,20858956,14.0
2022-10-12,21248603,15640,20500961,30409,105,388509,1.83,0.0014854997559421435,0.0002703370717087594,0.0007365905549781004,20889470,14.0
2022-10-13,21264080,15477,20531754,30793,101,388610,1.83,0.001502027148873708,0.00025996823754415027,0.0007283772961450553,20920364,14.0
2022-10-14,21278816,14736,20559274,27520,99,388709,1.83,0.0013403628350505679,0.00025475412367148564,0.0006929996501141568,20947983,15.0
2022-10-15,21292200,13384,20585404,26130,98,388807,1.83,0.0012709592760911106,0.00025211662194601914,0.0006289823644323178,20974211,15.0
2022-10-16,21304554,12354,20603845,18441,94,388901,1.83,0.000895828908677343,0.0002417651945567645,0.0005802124721729918,20992746,15.0
2022-10-17,21314957,10403,20618358,14513,92,388993,1.82,0.0007043830896611425,0.0002365640612906894,0.0004882993560906268,21007351,16.0
2022-10-18,21324431,9474,20638610,20252,91,389084,1.82,0.0009822314657645936,0.0002339373716235826,0.00044447661799185134,21027694,16.0
2022-10-19,21335087,10656,20659469,20859,92,389176,1.82,0.0010106785292227636,0.0002364527968252705,0.0004997085268065861,21048645,17.0
2022-10-20,21345154,10067,20677821,18352,90,389266,1.82,0.0008883093752312109,0.00023125783707111933,0.00047185183730436014,21067087,17.0
2022-10-21,21354915,9761,20693493,15672,93,389359,1.82,0.0007579135151620786,0.00023891118155705546,0.00045729349153433846,21082852,17.0
2022-10-22,21364263,9348,20708528,15035,90,389449,1.82,0.0007265568939955892,0.00023114914513344686,0.00043774465971879733,21097977,17.0
2022-10-23,21372935,8672,20719106,10578,88,389537,1.82,0.0005108040513550627,0.0002259602669412164,0.0004059114980938805,21108643,18.0
2022-10-24,21380264,7329,20727435,8329,89,389626,1.82,0.00040199610929159135,0.00022847637066569781,0.00034291032092692575,21117061,19.0
2022-10-25,21386842,6578,20740347,12912,84,389710,1.82,0.0006229424914370174,0.00021559136197280004,0.00030766692123163075,21130057,19.0
2022-10-26,21394360,7518,20751864,11517,80,389790,1.82,0.0005552944702420515,0.00020528084986271009,0.0003515245495337993,21141654,20.0
2022-10-27,21402209,7849,20763904,12040,82,389872,1.82,0.0005801888447225513,0.00021036968624121852,0.00036687239066734984,21153776,20.0
2022-10-28,21409815,7606,20775589,11685,78,389950,1.82,0.0005627554432923175,0.0002000656625764652,0.0003553838764960293,21165539,20.0
2022-10-29,21416922,7107,20787116,11527,79,390029,1.82,0.000554833848513292,0.00020259007565082143,0.00033195055632195825,21177145,21.0
2022-10-30,21423725,6803,20796124,9008,75,390104,1.82,0.0004333453471851989,0.00019229339356807704,0.0003176460184148855,21186228,21.0
2022-10-31,21429506,5781,20803197,7073,71,390175,1.82,0.0003401114553847062,0.0001820027479850772,0.00026984102904603624,21193372,22.0
2022-11-01,21434758,5252,20812505,9308,72,390247,1.82,0.0004474312289597382,0.00018453258153394716,0.00024508264446221345,21202752,23.0
2022-11-02,21441143,6385,20822746,10241,68,390315,1.82,0.0004920599418474224,0.00017424861690162882,0.0002978806665323574,21213061,23.0
2022-11-03,21447518,6375,20832520,9774,73,390388,1.82,0.0004693905405175336,0.00018702842575857304,0.00029732556701844715,21222908,23.0
2022-11-04,21453667,6149,20841779,9259,71,390459,1.82,0.00044444935130272256,0.0001818703443754455,0.00028669984097917656,21232238,24.0
2022-11-05,21459284,5617,20849598,7819,67,390526,1.82,0.0003751599131724959,0.00017159292012736138,0.00026182004223329614,21240124,24.0
2022-11-06,21463850,4566,20855333,5735,62,390588,1.82,0.0002750652554548428,0.0001587602361943219,0.0002127750394653738,21245921,25.0
2022-11-07,21468271,4421,20860277,4944,61,390649,1.82,0.00023706166667292197,0.0001561747928764401,0.00020597423109092186,21250926,25.0
2022-11-08,21472591,4320,20868400,8123,63,390712,1.82,0.0003894003900331011,0.00016127009156563507,0.00020122719710413683,21259112,26.0
2022-11-09,21477926,5335,20876892,8492,62,390774,1.82,0.0004069310536505277,0.00015868465775303878,0.0002484562761895237,21267666,26.0
2022-11-10,21483520,5594,20884515,7623,61,390835,1.82,0.00036514055827852044,0.00015610045704161912,0.0002604534534667025,21275350,27.0
2022-11-11,21489074,5554,20890728,6213,67,390902,1.82,0.00029749314264648774,0.00017142784039303471,0.0002585237428502918,21281630,27.0
2022-11-12,21494588,5514,20896445,5717,62,390964,1.82,0.00027366207630485917,0.000158607528229604,0.0002565955145390486,21287409,28.0
2022-11-13,21499952,5364,20901517,5072,60,391024,1.82,0.0002427207115851537,0.00015346681535888249,0.00024955118935054976,21292541,28.0
2022-11-14,21504530,4578,20905977,4460,61,391085,1.82,0.00021338164115070057,0.00015600065469123514,0.00021293070793837463,21297062,29.0
2022-11-15,21508961,4431,20912331,6354,64,391149,1.82,0.00030393221995805847,0.00016364728895257308,0.00020604960908232608,21303480,30.0
2022-11-16,21514341,5380,20919237,6906,63,391212,1.82,0.00033023578289759214,0.0001610639423850202,0.0002501283069880067,21310449,30.0
2022-11-17,21520021,5680,20925972,6735,61,391273,1.82,0.00032195246891642,0.00015592568735112167,0.0002640099457380529,21317245,30.0
2022-11-18,21525567,5546,20932860,6888,60,391333,1.82,0.0003291603372115315,0.00015334561802116117,0.000257713503160506,21324193,31.0
2022-11-19,21531012,5445,20939481,6621,62,391395,1.82,0.0003162969608547783,0.00015843284363947774,0.0002529550092686961,21330876,31.0
2022-11-20,21536229,5217,20943924,4443,59,391454,1.82,0.00021218290940439036,0.0001507428556828394,0.00024230166236494102,21335378,31.0
2022-11-21,21540891,4662,20948088,4164,55,391509,1.82,0.00019881661144305343,0.00014050182141445156,0.0002164724381412686,21339597,32.0
2022-11-22,21545351,4460,20954532,6444,59,391568,1.82,0.0003076175734988418,0.00015069896222064116,0.00020704807428817418,21346100,32.0
2022-11-23,21550982,5631,20961317,6785,54,391622,1.82,0.00032379630334866677,0.00013790708127325857,0.00026135568643081974,21352939,33.0
2022-11-24,21556766,5784,20967429,6112,58,391680,1.82,0.0002915847320090758,0.00014810199631276608,0.00026838684195462653,21359109,33.0
2022-11-25,21562758,5992,20972766,5337,56,391736,1.82,0.00025453764503025056,0.0001429738562090943,0.0002779637724878992,21364502,33.0
2022-11-26,21568846,6088,20977854,5088,53,391789,1.82,0.00024260033225953487,0.0001352951988073947,0.00028233865074223097,21369643,34.0
2022-11-27,21574764,5918,20982028,4174,51,391840,1.82,0.00019897173466842943,0.00013017210794585846,0.00027437721981038443,21373868,34.0
2022-11-28,21579812,5048,20986290,4262,50,391890,1.82,0.00020312621830465005,0.00012760310330750538,0.00023397706691019596,21378180,35.0
2022-11-29,21584740,4928,20992153,5863,53,391943,1.82,0.000279372866762051,0.0001352420322029424,0.0002283615816485174,21384096,35.0
2022-11-30,21590828,6088,20997710,5557,59,392002,1.82,0.00026471796389815344,0.00015053209267668066,0.0002820511157419769,21389712,35.0
2022-12-01,21597613,6785,21003575,5865,58,392060,1.82,0.0002793161730494376,0.00014795842878356782,0.00031425381185012924,21395635,35.0
2022-12-02,21604334,6721,21009259,5684,57,392117,1.81,0.0002706205967317743,0.00014538591031976192,0.00031119179698246846,21401376,36.0
2022-12-03,21611003,6669,21014391,5132,59,392176,1.81,0.00024427325114140247,0.0001504652947972307,0.0003086880623119903,21406567,36.0
2022-12-04,21617601,6598,21018980,4589,55,392231,1.81,0.00021837416083103636,0.00014024315613392346,0.00030530743991841186,21411211,36.0
2022-12-05,21623268,5667,21023627,4647,52,392283,1.81,0.0002210858947484517,0.00013257493670826292,0.00026214749731012793,21415910,37.0
2022-12-06,21628829,5561,21030317,6690,59,392342,1.81,0.00031821340818116717,0.00015040162331780846,0.0002571766672827547,21422659,37.0
2022-12-07,21635764,6935,21037111,6794,58,392400,1.81,0.00032305742229188367,0.0001478302093582684,0.000320636868505364,21429511,36.0
2022-12-08,21643194,7430,21043426,6315,54,392454,1.81,0.00030018380375507187,0.00013761467889916723,0.00034341287878714155,21435880,36.0
2022-12-09,21650659,7465,21049420,5994,52,392506,1.81,0.00028483955036606723,0.0001324996050493521,0.0003449121234140317,21441926,36.0
2022-12-10,21658056,7397,21055866,6446,54,392560,1.81,0.000306231715648142,0.00013757751473852942,0.0003416524180626101,21448426,36.0
2022-12-11,21665152,7096,21061584,5718,51,392611,1.81,0.0002715632783756305,0.00012991644589366302,0.0003276379006500463,21454195,36.0
2022-12-12,21671528,6376,21066616,5032,50,392661,1.81,0.00023891840233858375,0.0001273525194149805,0.00029429749673570704,21459277,37.0
2022-12-13,21677505,5977,21073454,6838,59,392720,1.81,0.0003245893882528605,0.00015025683732283746,0.0002757996575044608,21466174,36.0
2022-12-14,21685037,7532,21081129,7675,55,392775,1.81,0.00036420228027167484,0.00014004888979424202,0.00034745696056814884,21473904,35.0
2022-12-15,21692870,7833,21088668,7539,57,392832,1.81,0.00035761841787507187,0.00014512125262555742,0.0003612168150786133,21481500,35.0
2022-12-16,21701321,8451,21096061,7393,59,392891,1.81,0.00035056742322470136,0.00015019143043337738,0.00038957500782510485,21488952,35.0
2022-12-17,21708852,7531,21103330,7269,58,392949,1.81,0.000344566694227888,0.00014762364116260862,0.00034702956561960535,21496279,34.0
2022-12-18,21716074,7222,21109668,6338,51,393000,1.81,0.00030033174859123163,0.00012978783506256697,0.0003326753528929416,21502668,34.0
2022-12-19,21722415,6341,21115232,5564,50,393050,1.81,0.0002635759122313619,0.00012722646310425745,0.000291995689460256,21508282,34.0
2022-12-20,21728409,5994,21123341,8109,57,393107,1.81,0.0003840355625739367,0.00014501971759317556,0.0002759361700805929,21516448,33.0
2022-12-21,21735851,7442,21131700,8359,59,393166,1.81,0.0003957233848566055,0.00015008636325486435,0.00034250091665710686,21524866,33.0
2022-12-22,21743302,7451,21140943,9243,54,393220,1.81,0.0004373997359417015,0.0001373465660814421,0.0003427977124061954,21534163,32.0
2022-12-23,21750711,7409,21149218,8275,57,393277,1.81,0.0003914205719206532,0.0001449570215146245,0.00034074861306709886,21542495,31.0
2022-12-24,21757697,6986,21157222,8004,54,393331,1.81,0.000378453709257709,0.00013730780086307348,0.0003211849028750269,21550553,31.0
2022-12-25,21764292,6595,21163398,6176,52,393383,1.81,0.00029190977908166715,0.0001322041740925428,0.0003031111243070317,21556781,30.0
2022-12-26,21769627,5335,21168975,5577,50,393433,1.81,0.0002635210092443163,0.00012710259467230145,0.00024512628299611094,21562408,31.0
2022-12-27,21774824,5197,21176667,7692,59,393492,1.81,0.0003633619483229822,0.0001499620011540248,0.0002387271035926286,21570159,30.0
2022-12-28,21781026,6202,21184777,8110,56,393548,1.81,0.0003829686701877222,0.00014231547274157208,0.00028482434576737603,21578325,30.0
2022-12-29,21787172,6146,21192592,7815,56,393604,1.81,0.00036889696785569187,0.00014229522192965582,0.0002821721988670589,21586196,29.0
2022-12-30,21792982,5810,21200287,7695,50,393654,1.81,0.00036309857708771714,0.00012703122935753264,0.000266670681261516,21593941,29.0
2022-12-31,21798509,5527,21207802,7515,58,393712,1.81,0.0003544763332685718,0.0001473375095897289,0.00025361375510701833,21601514,29.0
2023-01-01,21803547,5038,21213085,5283,50,393762,1.81,0.0002491064373384422,0.00012699638314295214,0.00023111672454301235,21606847,29.0
2023-01-02,21807431,3884,21217574,4489,43,393805,1.81,0.0002116146708506239,0.00010920302111427917,0.0001781361537185333,21611379,29.0
2023-01-03,21810511,3080,21223056,5482,48,393853,1.81,0.0002583707260783718,0.00012188773631627292,0.00014123626024531433,21616909,30.0
2023-01-04,21813839,3328,21227998,4942,45,393898,1.81,0.0002328599613552473,0.00011425582641244604,0.00015258697973652424,21621896,30.0
2023-01-05,21817113,3274,21232717,4719,47,393945,1.81,0.0002223007558226353,0.00011932023011040903,0.0001500882077656307,21626662,30.0
2023-01-06,21820552,3439,21237402,4685,41,393986,1.81,0.0002206500468122652,0.00010407544200341512,0.00015762855516210372,21631388,30.0
2023-01-07,21823855,3303,21241865,4463,49,394035,1.81,0.0002101481151037809,0.00012436990146857949,0.00015137105605766976,21635900,30.0
2023-01-08,21826982,3127,21245559,3694,45,394080,1.81,0.00017390186784438377,0.00011420305302833889,0.00014328357661841373,21639639,31.0
2023-01-09,21829736,2754,21248549,2990,41,394121,1.81,0.00014073529437386154,0.00010403978887540966,0.00012617410872461932,21642670,32.0
2023-01-10,21832768,3032,21253611,5062,47,394168,1.81,0.0002382280314763285,0.00011925271680524041,0.0001388931135035687,21647779,32.0
2023-01-11,21836969,4201,21258733,5122,46,394214,1.81,0.00024099434209090556,0.00011670150798637202,0.0001924171960239196,21652947,32.0
2023-01-12,21841644,4675,21263274,4541,48,394262,1.81,0.00021360633298317389,0.00012176127687002493,0.0002140864879187632,21657536,33.0
2023-01-13,21846722,5078,21267545,4271,47,394309,1.8,0.000200862764595966,0.00011921006843174099,0.00023249165676353373,21661854,33.0
