"DateTime";"Заражений";"Заражений за день";"Выздоровлений";"Выздоровлений за день";"Смертей за день";"Смертей";"Летальность, %"
2020-03-12 00:00:00;34;34;0;0;0;0;0
2020-03-13 00:00:00;45;11;0;0;0;0;0
2020-03-14 00:00:00;59;14;0;0;0;0;0
2020-03-15 00:00:00;63;4;3;3;0;0;0
2020-03-16 00:00:00;91;28;5;2;0;0;0
2020-03-17 00:00:00;114;23;5;0;0;0;0
2020-03-18 00:00:00;147;33;5;0;0;0;0
2020-03-19 00:00:00;199;52;5;0;0;0;0
2020-03-20 00:00:00;253;54;12;7;0;0;0
2020-03-21 00:00:00;306;53;16;4;0;0;0
2020-03-22 00:00:00;367;61;16;0;0;0;0
2020-03-23 00:00:00;438;71;17;1;0;0;0
2020-03-24 00:00:00;495;57;22;5;0;0;0
2020-03-25 00:00:00;658;163;29;7;2;2;0.3
2020-03-26 00:00:00;840;182;35;6;0;2;0.24
2020-03-27 00:00:00;1036;196;42;7;1;3;0.29
2020-03-28 00:00:00;1264;228;46;4;2;5;0.4
2020-03-29 00:00:00;1534;270;64;18;3;8;0.52
2020-03-30 00:00:00;1836;302;66;2;1;9;0.49
2020-03-31 00:00:00;2337;501;121;55;8;17;0.73
2020-04-01 00:00:00;2777;440;190;69;7;24;0.86
2020-04-02 00:00:00;3548;771;235;45;6;30;0.85
2020-04-03 00:00:00;4149;601;281;46;4;34;0.82
2020-04-04 00:00:00;4731;582;333;52;9;43;0.91
2020-04-05 00:00:00;5389;658;355;22;2;45;0.84
2020-04-06 00:00:00;6343;954;406;51;2;47;0.74
2020-04-07 00:00:00;7497;1154;494;88;11;58;0.77
2020-04-08 00:00:00;8672;1175;580;86;5;63;0.73
2020-04-09 00:00:00;10131;1459;698;118;13;76;0.75
2020-04-10 00:00:00;11917;1786;795;97;18;94;0.79
2020-04-11 00:00:00;13584;1667;1045;250;12;106;0.78
2020-04-12 00:00:00;15759;2175;1291;246;24;130;0.82
2020-04-13 00:00:00;18328;2569;1470;179;18;148;0.81
2020-04-14 00:00:00;21102;2774;1694;224;22;170;0.81
2020-04-15 00:00:00;24490;3388;1986;292;28;198;0.81
2020-04-16 00:00:00;27938;3448;2304;318;34;232;0.83
2020-04-17 00:00:00;32008;4070;2590;286;41;273;0.85
2020-04-18 00:00:00;36793;4785;3057;467;40;313;0.85
2020-04-19 00:00:00;42853;6060;3291;234;48;361;0.84
2020-04-20 00:00:00;47121;4268;3446;155;44;405;0.86
2020-04-21 00:00:00;52763;5642;3873;427;51;456;0.86
2020-04-22 00:00:00;57999;5236;4420;547;57;513;0.88
2020-04-23 00:00:00;62773;4774;4891;471;42;555;0.88
2020-04-24 00:00:00;68622;5849;5568;677;60;615;0.9
2020-04-25 00:00:00;74588;5966;6250;682;66;681;0.91
2020-04-26 00:00:00;80949;6361;6767;517;62;743;0.92
2020-04-27 00:00:00;87147;6198;7346;579;50;793;0.91
2020-04-28 00:00:00;93558;6411;8456;1110;71;864;0.92
2020-04-29 00:00:00;99399;5841;10286;1830;108;972;0.98
2020-04-30 00:00:00;106498;7099;11619;1333;101;1073;1.01
2020-05-01 00:00:00;114431;7933;13220;1601;92;1165;1.02
2020-05-02 00:00:00;124054;9623;15013;1793;57;1222;0.99
2020-05-03 00:00:00;134687;10633;16639;1626;58;1280;0.95
2020-05-04 00:00:00;145268;10581;18095;1456;76;1356;0.93
2020-05-05 00:00:00;155370;10102;19865;1770;95;1451;0.93
2020-05-06 00:00:00;165929;10559;21327;1462;86;1537;0.93
2020-05-07 00:00:00;177160;11231;23803;2476;88;1625;0.92
2020-05-08 00:00:00;187859;10699;26608;2805;98;1723;0.92
2020-05-09 00:00:00;198676;10817;31916;5308;104;1827;0.92
2020-05-10 00:00:00;209688;11012;34306;2390;88;1915;0.91
2020-05-11 00:00:00;221344;11656;39801;5495;94;2009;0.91
2020-05-12 00:00:00;232243;10899;43512;3711;107;2116;0.91
2020-05-13 00:00:00;242271;10028;48003;4491;96;2212;0.91
2020-05-14 00:00:00;252245;9974;53530;5527;93;2305;0.91
2020-05-15 00:00:00;262843;10598;58226;4696;113;2418;0.92
2020-05-16 00:00:00;272043;9200;63166;4940;119;2537;0.93
2020-05-17 00:00:00;281752;9709;67373;4207;94;2631;0.93
2020-05-18 00:00:00;290678;8926;70209;2836;91;2722;0.94
2020-05-19 00:00:00;299941;9263;76130;5921;115;2837;0.95
2020-05-20 00:00:00;308705;8764;85392;9262;135;2972;0.96
2020-05-21 00:00:00;317554;8849;92681;7289;127;3099;0.98
2020-05-22 00:00:00;326448;8894;99825;7144;150;3249;1
2020-05-23 00:00:00;335882;9434;107936;8111;139;3388;1.01
2020-05-24 00:00:00;344481;8599;113299;5363;153;3541;1.03
2020-05-25 00:00:00;353427;8946;118798;5499;92;3633;1.03
2020-05-26 00:00:00;362342;8915;131129;12331;174;3807;1.05
2020-05-27 00:00:00;370680;8338;142208;11079;161;3968;1.07
2020-05-28 00:00:00;379051;8371;150993;8785;174;4142;1.09
2020-05-29 00:00:00;387623;8572;159257;8264;232;4374;1.13
2020-05-30 00:00:00;396575;8952;167469;8212;181;4555;1.15
2020-05-31 00:00:00;405843;9268;171883;4414;138;4693;1.16
2020-06-01 00:00:00;414878;9035;175877;3994;162;4855;1.17
2020-06-02 00:00:00;423741;8863;186985;11108;182;5037;1.19
2020-06-03 00:00:00;432277;8536;195957;8972;178;5215;1.21
2020-06-04 00:00:00;441108;8831;204623;8666;169;5384;1.22
2020-06-05 00:00:00;449834;8726;212680;8057;144;5528;1.23
2020-06-06 00:00:00;458689;8855;221388;8708;197;5725;1.25
2020-06-07 00:00:00;467673;8984;226731;5343;134;5859;1.25
2020-06-08 00:00:00;476658;8985;230688;3957;112;5971;1.25
2020-06-09 00:00:00;485253;8595;242397;11709;171;6142;1.27
2020-06-10 00:00:00;493657;8404;252783;10386;216;6358;1.29
2020-06-11 00:00:00;502436;8779;261150;8367;174;6532;1.3
2020-06-12 00:00:00;511423;8987;269370;8220;183;6715;1.31
2020-06-13 00:00:00;520129;8706;274641;5271;114;6829;1.31
2020-06-14 00:00:00;528964;8835;280050;5409;119;6948;1.31
2020-06-15 00:00:00;537210;8246;284539;4489;143;7091;1.32
2020-06-16 00:00:00;545458;8248;294306;9767;193;7284;1.34
2020-06-17 00:00:00;553301;7843;304342;10036;194;7478;1.35
2020-06-18 00:00:00;561091;7790;313963;9621;182;7660;1.37
2020-06-19 00:00:00;569063;7972;324406;10443;181;7841;1.38
2020-06-20 00:00:00;576952;7889;334592;10186;161;8002;1.39
2020-06-21 00:00:00;584680;7728;339711;5119;109;8111;1.39
2020-06-22 00:00:00;592280;7600;344416;4705;95;8206;1.39
2020-06-23 00:00:00;599705;7425;356429;12013;153;8359;1.39
2020-06-24 00:00:00;606881;7176;368822;12393;154;8513;1.4
2020-06-25 00:00:00;613994;7113;375164;6342;92;8605;1.4
2020-06-26 00:00:00;620794;6800;384152;8988;176;8781;1.41
2020-06-27 00:00:00;627646;6852;393352;9200;188;8969;1.43
2020-06-28 00:00:00;634437;6791;399087;5735;104;9073;1.43
2020-06-29 00:00:00;641156;6719;403430;4343;93;9166;1.43
2020-06-30 00:00:00;647849;6693;412650;9220;154;9320;1.44
2020-07-01 00:00:00;654405;6556;422931;10281;216;9536;1.46
2020-07-02 00:00:00;661165;6760;428978;6047;147;9683;1.46
2020-07-03 00:00:00;667883;6718;437893;8915;176;9859;1.48
2020-07-04 00:00:00;674515;6632;446879;8986;168;10027;1.49
2020-07-05 00:00:00;681251;6736;450750;3871;134;10161;1.49
2020-07-06 00:00:00;687862;6611;454329;3579;135;10296;1.5
2020-07-07 00:00:00;694230;6368;463880;9551;198;10494;1.51
2020-07-08 00:00:00;700792;6562;472511;8631;173;10667;1.52
2020-07-09 00:00:00;707301;6509;481316;8805;176;10843;1.53
2020-07-10 00:00:00;713936;6635;489068;7752;174;11017;1.54
2020-07-11 00:00:00;720547;6611;497446;8378;188;11205;1.56
2020-07-12 00:00:00;727162;6615;501061;3615;130;11335;1.56
2020-07-13 00:00:00;733699;6537;504021;2960;104;11439;1.56
2020-07-14 00:00:00;739947;6248;512825;8804;175;11614;1.57
2020-07-15 00:00:00;746369;6422;523249;10424;156;11770;1.58
2020-07-16 00:00:00;752797;6428;531692;8443;167;11937;1.59
2020-07-17 00:00:00;759203;6406;539373;7681;186;12123;1.6
2020-07-18 00:00:00;765437;6234;546863;7490;124;12247;1.6
2020-07-19 00:00:00;771546;6109;550344;3481;95;12342;1.6
2020-07-20 00:00:00;777486;5940;553602;3258;85;12427;1.6
2020-07-21 00:00:00;783328;5842;562384;8782;153;12580;1.61
2020-07-22 00:00:00;789190;5862;572053;9669;165;12745;1.61
2020-07-23 00:00:00;795038;5848;580330;8277;147;12892;1.62
2020-07-24 00:00:00;800849;5811;588774;8444;154;13046;1.63
2020-07-25 00:00:00;806720;5871;597140;8366;146;13192;1.64
2020-07-26 00:00:00;812485;5765;600250;3110;77;13269;1.63
2020-07-27 00:00:00;818120;5635;603329;3079;85;13354;1.63
2020-07-28 00:00:00;823515;5395;612217;8888;150;13504;1.64
2020-07-29 00:00:00;828990;5475;620333;8116;169;13673;1.65
2020-07-30 00:00:00;834499;5509;629655;9322;129;13802;1.65
2020-07-31 00:00:00;839981;5482;638410;8755;161;13963;1.66
2020-08-01 00:00:00;845443;5462;646524;8114;95;14058;1.66
2020-08-02 00:00:00;850870;5427;650173;3649;70;14128;1.66
2020-08-03 00:00:00;856264;5394;653593;3420;79;14207;1.66
2020-08-04 00:00:00;861423;5159;661471;7878;144;14351;1.67
2020-08-05 00:00:00;866627;5204;669026;7555;139;14490;1.67
2020-08-06 00:00:00;871894;5267;676357;7331;116;14606;1.68
2020-08-07 00:00:00;877135;5241;683592;7235;119;14725;1.68
2020-08-08 00:00:00;882347;5212;690207;6615;129;14854;1.68
2020-08-09 00:00:00;887536;5189;693422;3215;77;14931;1.68
2020-08-10 00:00:00;892654;5118;696681;3259;70;15001;1.68
2020-08-11 00:00:00;897599;4945;703175;6494;130;15131;1.69
2020-08-12 00:00:00;902701;5102;710298;7123;129;15260;1.69
2020-08-13 00:00:00;907758;5057;716396;6098;124;15384;1.69
2020-08-14 00:00:00;912823;5065;722964;6568;114;15498;1.7
2020-08-15 00:00:00;917884;5061;729411;6447;119;15617;1.7
2020-08-16 00:00:00;922853;4969;732968;3557;68;15685;1.7
2020-08-17 00:00:00;927745;4892;736101;3133;55;15740;1.7
2020-08-18 00:00:00;932493;4748;742628;6527;132;15872;1.7
2020-08-19 00:00:00;937321;4828;749423;6795;117;15989;1.71
2020-08-20 00:00:00;942106;4785;755513;6090;110;16099;1.71
2020-08-21 00:00:00;946976;4870;761330;5817;90;16189;1.71
2020-08-22 00:00:00;951897;4921;767477;6147;121;16310;1.71
2020-08-23 00:00:00;956749;4852;770639;3162;73;16383;1.71
2020-08-24 00:00:00;961493;4744;773095;2456;65;16448;1.71
2020-08-25 00:00:00;966189;4696;779747;6652;120;16568;1.71
2020-08-26 00:00:00;970865;4676;786150;6403;115;16683;1.72
2020-08-27 00:00:00;975576;4711;792561;6411;121;16804;1.72
2020-08-28 00:00:00;980405;4829;798466;5905;110;16914;1.73
2020-08-29 00:00:00;985346;4941;804383;5917;111;17025;1.73
2020-08-30 00:00:00;990326;4980;806982;2599;68;17093;1.73
2020-08-31 00:00:00;995319;4993;809387;2405;83;17176;1.73
2020-09-01 00:00:00;1000048;4729;815705;6318;123;17299;1.73
2020-09-02 00:00:00;1005000;4952;821169;5464;115;17414;1.73
2020-09-03 00:00:00;1009995;4995;826935;5766;114;17528;1.74
2020-09-04 00:00:00;1015105;5110;832747;5812;121;17649;1.74
2020-09-05 00:00:00;1020310;5205;838126;5379;110;17759;1.74
2020-09-06 00:00:00;1025505;5195;840949;2823;61;17820;1.74
2020-09-07 00:00:00;1030690;5185;843277;2328;51;17871;1.73
2020-09-08 00:00:00;1035789;5099;850049;6772;122;17993;1.74
2020-09-09 00:00:00;1041007;5218;856458;6409;142;18135;1.74
2020-09-10 00:00:00;1046370;5363;862373;5915;128;18263;1.75
2020-09-11 00:00:00;1051874;5504;868107;5734;102;18365;1.75
2020-09-12 00:00:00;1057362;5488;873535;5428;119;18484;1.75
2020-09-13 00:00:00;1062811;5449;876225;2690;94;18578;1.75
2020-09-14 00:00:00;1068320;5509;878700;2475;57;18635;1.74
2020-09-15 00:00:00;1073849;5529;884305;5605;150;18785;1.75
2020-09-16 00:00:00;1079519;5670;890114;5809;132;18917;1.75
2020-09-17 00:00:00;1085281;5762;895868;5754;144;19061;1.76
2020-09-18 00:00:00;1091186;5905;901207;5339;134;19195;1.76
2020-09-19 00:00:00;1097251;6065;906462;5255;144;19339;1.76
2020-09-20 00:00:00;1103399;6148;909357;2895;79;19418;1.76
2020-09-21 00:00:00;1109595;6196;911973;2616;71;19489;1.76
2020-09-22 00:00:00;1115810;6215;917949;5976;160;19649;1.76
2020-09-23 00:00:00;1122241;6431;923699;5750;150;19799;1.76
2020-09-24 00:00:00;1128836;6595;929829;6130;149;19948;1.77
2020-09-25 00:00:00;1136048;7212;934146;4317;108;20056;1.77
2020-09-26 00:00:00;1143571;7523;940150;6004;169;20225;1.77
2020-09-27 00:00:00;1151438;7867;943218;3068;99;20324;1.77
2020-09-28 00:00:00;1159573;8135;945920;2702;61;20385;1.76
2020-09-29 00:00:00;1167805;8232;952399;6479;160;20545;1.76
2020-09-30 00:00:00;1176286;8481;958257;5858;177;20722;1.76
2020-10-01 00:00:00;1185231;8945;964242;5985;169;20891;1.76
2020-10-02 00:00:00;1194643;9412;970296;6054;186;21077;1.76
2020-10-03 00:00:00;1204502;9859;975859;5563;174;21251;1.76
2020-10-04 00:00:00;1215001;10499;979143;3284;107;21358;1.76
2020-10-05 00:00:00;1225889;10888;982324;3181;117;21475;1.75
2020-10-06 00:00:00;1237504;11615;988576;6252;188;21663;1.75
2020-10-07 00:00:00;1248619;11115;995275;6699;202;21865;1.75
2020-10-08 00:00:00;1260112;11493;1002329;7054;191;22056;1.75
2020-10-09 00:00:00;1272238;12126;1009421;7092;201;22257;1.75
2020-10-10 00:00:00;1285084;12846;1016202;6781;191;22448;1.75
2020-10-11 00:00:00;1298718;13634;1020442;4240;149;22597;1.74
2020-10-12 00:00:00;1312310;13592;1024235;3793;125;22722;1.73
2020-10-13 00:00:00;1326178;13868;1031785;7550;244;22966;1.73
2020-10-14 00:00:00;1340409;14231;1039705;7920;239;23205;1.73
2020-10-15 00:00:00;1354163;13754;1048097;8392;286;23491;1.73
2020-10-16 00:00:00;1369313;15150;1056582;8485;232;23723;1.73
2020-10-17 00:00:00;1384235;14922;1065199;8617;279;24002;1.73
2020-10-18 00:00:00;1399334;15099;1070576;5377;185;24187;1.73
2020-10-19 00:00:00;1415316;15982;1075904;5328;179;24366;1.72
2020-10-20 00:00:00;1431635;16319;1085608;9704;269;24635;1.72
2020-10-21 00:00:00;1447335;15700;1096560;10952;317;24952;1.72
2020-10-22 00:00:00;1463306;15971;1107988;11428;290;25242;1.72
2020-10-23 00:00:00;1480646;17340;1119251;11263;283;25525;1.72
2020-10-24 00:00:00;1497167;16521;1130818;11567;296;25821;1.72
2020-10-25 00:00:00;1513877;16710;1138522;7704;229;26050;1.72
2020-10-26 00:00:00;1531224;17347;1146096;7574;219;26269;1.72
2020-10-27 00:00:00;1547774;16550;1158940;12844;320;26589;1.72
2020-10-28 00:00:00;1563976;16202;1171301;12361;346;26935;1.72
2020-10-29 00:00:00;1581693;17717;1186041;14740;366;27301;1.73
2020-10-30 00:00:00;1599976;18283;1200560;14519;355;27656;1.73
2020-10-31 00:00:00;1618116;18140;1215414;14854;334;27990;1.73
2020-11-01 00:00:00;1636781;18665;1225673;10259;245;28235;1.73
2020-11-02 00:00:00;1655038;18257;1236033;10360;238;28473;1.72
2020-11-03 00:00:00;1673686;18648;1251364;15331;355;28828;1.72
2020-11-04 00:00:00;1693454;19768;1266931;15567;389;29217;1.73
2020-11-05 00:00:00;1712858;19404;1279169;12238;292;29509;1.72
2020-11-06 00:00:00;1733440;20582;1296124;16955;378;29887;1.72
2020-11-07 00:00:00;1753836;20396;1312927;16803;364;30251;1.72
2020-11-08 00:00:00;1774334;20498;1324419;11492;286;30537;1.72
2020-11-09 00:00:00;1796132;21798;1335141;10722;256;30793;1.71
2020-11-10 00:00:00;1817109;20977;1350741;15600;368;31161;1.71
2020-11-11 00:00:00;1836960;19851;1369357;18616;432;31593;1.72
2020-11-12 00:00:00;1858568;21608;1388168;18811;439;32032;1.72
2020-11-13 00:00:00;1880551;21983;1406903;18735;411;32443;1.73
2020-11-14 00:00:00;1903253;22702;1425529;18626;391;32834;1.73
2020-11-15 00:00:00;1925825;22572;1439985;14456;352;33186;1.72
2020-11-16 00:00:00;1948603;22778;1453849;13864;303;33489;1.72
2020-11-17 00:00:00;1971013;22410;1475904;22055;442;33931;1.72
2020-11-18 00:00:00;1991998;20985;1501083;25179;456;34387;1.73
2020-11-19 00:00:00;2015608;23610;1526656;25573;463;34850;1.73
2020-11-20 00:00:00;2039926;24318;1551414;24758;461;35311;1.73
2020-11-21 00:00:00;2064748;24822;1577435;26021;467;35778;1.73
2020-11-22 00:00:00;2089329;24581;1595443;18008;401;36179;1.73
2020-11-23 00:00:00;2114502;25173;1611445;16002;361;36540;1.73
2020-11-24 00:00:00;2138828;24326;1634671;23226;491;37031;1.73
2020-11-25 00:00:00;2162503;23675;1660419;25748;507;37538;1.74
2020-11-26 00:00:00;2187990;25487;1685492;25073;524;38062;1.74
2020-11-27 00:00:00;2215533;27543;1712174;26682;496;38558;1.74
2020-11-28 00:00:00;2242633;27100;1739470;27296;510;39068;1.74
2020-11-29 00:00:00;2269316;26683;1761457;21987;459;39527;1.74
2020-11-30 00:00:00;2295654;26338;1778704;17247;368;39895;1.74
2020-12-01 00:00:00;2322056;26402;1803467;24763;569;40464;1.74
2020-12-02 00:00:00;2347401;25345;1830349;26882;589;41053;1.75
2020-12-03 00:00:00;2375546;28145;1859851;29502;554;41607;1.75
2020-12-04 00:00:00;2402949;27403;1888752;28901;569;42176;1.76
2020-12-05 00:00:00;2431731;28782;1916396;27644;508;42684;1.76
2020-12-06 00:00:00;2460770;29039;1937738;21342;457;43141;1.75
2020-12-07 00:00:00;2488912;28142;1956588;18850;456;43597;1.75
2020-12-08 00:00:00;2515009;26097;1981526;24938;562;44159;1.76
2020-12-09 00:00:00;2541199;26190;2007792;26266;559;44718;1.76
2020-12-10 00:00:00;2569126;27927;2033669;25877;562;45280;1.76
2020-12-11 00:00:00;2597711;28585;2059840;26171;613;45893;1.77
2020-12-12 00:00:00;2625848;28137;2085958;26118;560;46453;1.77
2020-12-13 00:00:00;2653928;28080;2106235;20277;488;46941;1.77
2020-12-14 00:00:00;2681256;27328;2124797;18562;450;47391;1.77
2020-12-15 00:00:00;2707945;26689;2149610;24813;577;47968;1.77
2020-12-16 00:00:00;2734454;26509;2176100;26490;596;48564;1.78
2020-12-17 00:00:00;2762668;28214;2202540;26440;587;49151;1.78
2020-12-18 00:00:00;2791220;28552;2228633;26093;611;49762;1.78
2020-12-19 00:00:00;2819429;28209;2254742;26109;585;50347;1.79
2020-12-20 00:00:00;2848377;28948;2275657;20915;511;50858;1.79
2020-12-21 00:00:00;2877727;29350;2295362;19705;493;51351;1.78
2020-12-22 00:00:00;2906503;28776;2319520;24158;561;51912;1.79
2020-12-23 00:00:00;2933753;27250;2343967;24447;549;52461;1.79
2020-12-24 00:00:00;2963688;29935;2370857;26890;635;53096;1.79
2020-12-25 00:00:00;2992706;29018;2398254;27397;563;53659;1.79
2020-12-26 00:00:00;3021964;29258;2426439;28185;567;54226;1.79
2020-12-27 00:00:00;3050248;28284;2450829;24390;552;54778;1.8
2020-12-28 00:00:00;3078035;27787;2471309;20480;487;55265;1.8
2020-12-29 00:00:00;3105037;27002;2496183;24874;562;55827;1.8
2020-12-30 00:00:00;3131550;26513;2525418;29235;599;56426;1.8
2020-12-31 00:00:00;3159297;27747;2554340;28922;593;57019;1.8
2021-01-01 00:00:00;3186336;27039;2580138;25798;536;57555;1.81
2021-01-02 00:00:00;3212637;26301;2599035;18897;447;58002;1.81
2021-01-03 00:00:00;3236787;24150;2618882;19847;504;58506;1.81
2021-01-04 00:00:00;3260138;23351;2640036;21154;482;58988;1.81
2021-01-05 00:00:00;3284384;24246;2662668;22632;518;59506;1.81
2021-01-06 00:00:00;3308601;24217;2685723;23055;445;59951;1.81
2021-01-07 00:00:00;3332142;23541;2709452;23729;506;60457;1.81
2021-01-08 00:00:00;3355794;23652;2731129;21677;454;60911;1.82
2021-01-09 00:00:00;3379103;23309;2754809;23680;470;61381;1.82
2021-01-10 00:00:00;3401954;22851;2778889;24080;456;61837;1.82
2021-01-11 00:00:00;3425269;23315;2800675;21786;436;62273;1.82
2021-01-12 00:00:00;3448203;22934;2825430;24755;531;62804;1.82
2021-01-13 00:00:00;3471053;22850;2854088;28658;566;63370;1.83
2021-01-14 00:00:00;3495816;24763;2882044;27956;570;63940;1.83
2021-01-15 00:00:00;3520531;24715;2909680;27636;555;64495;1.83
2021-01-16 00:00:00;3544623;24092;2936991;27311;590;65085;1.84
2021-01-17 00:00:00;3568209;23586;2960431;23440;481;65566;1.84
2021-01-18 00:00:00;3591066;22857;2978764;18333;471;66037;1.84
2021-01-19 00:00:00;3612800;21734;3002026;23262;586;66623;1.84
2021-01-20 00:00:00;3633952;21152;3027316;25290;597;67220;1.85
2021-01-21 00:00:00;3655839;21887;3054218;26902;612;67832;1.86
2021-01-22 00:00:00;3677352;21513;3081536;27318;580;68412;1.86
2021-01-23 00:00:00;3698273;20921;3109315;27779;559;68971;1.86
2021-01-24 00:00:00;3719400;21127;3131760;22445;491;69462;1.87
2021-01-25 00:00:00;3738690;19290;3150763;19003;456;69918;1.87
2021-01-26 00:00:00;3756931;18241;3174561;23798;564;70482;1.88
2021-01-27 00:00:00;3774672;17741;3202483;27922;594;71076;1.88
2021-01-28 00:00:00;3793810;19138;3229258;26775;575;71651;1.89
2021-01-29 00:00:00;3813048;19238;3255462;26204;534;72185;1.89
2021-01-30 00:00:00;3832080;19032;3279964;24502;512;72697;1.9
2021-01-31 00:00:00;3850439;18359;3300004;20040;485;73182;1.9
2021-02-01 00:00:00;3868087;17648;3318173;18169;437;73619;1.9
2021-02-02 00:00:00;3884730;16643;3340545;22372;539;74158;1.91
2021-02-03 00:00:00;3901204;16474;3365367;24822;526;74684;1.91
2021-02-04 00:00:00;3917918;16714;3389913;24546;521;75205;1.92
2021-02-05 00:00:00;3934606;16688;3413495;23582;527;75732;1.92
2021-02-06 00:00:00;3951233;16627;3436326;22831;497;76229;1.93
2021-02-07 00:00:00;3967281;16048;3456210;19884;432;76661;1.93
2021-02-08 00:00:00;3983197;15916;3472091;15881;407;77068;1.93
2021-02-09 00:00:00;3998216;15019;3493886;21795;530;77598;1.94
2021-02-10 00:00:00;4012710;14494;3516461;22575;536;78134;1.95
2021-02-11 00:00:00;4027748;15038;3538422;21961;553;78687;1.95
2021-02-12 00:00:00;4042837;15089;3559142;20720;507;79194;1.96
2021-02-13 00:00:00;4057698;14861;3577907;18765;502;79696;1.96
2021-02-14 00:00:00;4071883;14185;3593101;15194;430;80126;1.97
2021-02-15 00:00:00;4086090;14207;3607036;13935;394;80520;1.97
2021-02-16 00:00:00;4099323;13233;3624663;17627;459;80979;1.98
2021-02-17 00:00:00;4112151;12828;3642582;17919;467;81446;1.98
2021-02-18 00:00:00;4125598;13447;3661312;18730;480;81926;1.99
2021-02-19 00:00:00;4139031;13433;3679949;18637;470;82396;1.99
2021-02-20 00:00:00;4151984;12953;3697433;17484;480;82876;2
2021-02-21 00:00:00;4164726;12742;3713445;16012;417;83293;2
2021-02-22 00:00:00;4177330;12604;3726388;12943;337;83630;2
2021-02-23 00:00:00;4189153;11823;3739344;12956;417;84047;2.01
2021-02-24 00:00:00;4200902;11749;3751562;12218;383;84430;2.01
2021-02-25 00:00:00;4212100;11198;3767664;16102;446;84876;2.02
2021-02-26 00:00:00;4223186;11086;3783386;15722;428;85304;2.02
2021-02-27 00:00:00;4234720;11534;3799406;16020;439;85743;2.02
2021-02-28 00:00:00;4246079;11359;3811797;12391;379;86122;2.03
2021-03-01 00:00:00;4257650;11571;3823074;11277;333;86455;2.03
2021-03-02 00:00:00;4268215;10565;3838040;14966;441;86896;2.04
2021-03-03 00:00:00;4278750;10535;3853734;15694;452;87348;2.04
2021-03-04 00:00:00;4290135;11385;3869857;16123;475;87823;2.05
2021-03-05 00:00:00;4301159;11024;3885321;15464;462;88285;2.05
2021-03-06 00:00:00;4312181;11022;3900348;15027;441;88726;2.06
2021-03-07 00:00:00;4322776;10595;3911924;11576;368;89094;2.06
2021-03-08 00:00:00;4333029;10253;3922246;10322;379;89473;2.06
2021-03-09 00:00:00;4342474;9445;3932177;9931;336;89809;2.07
2021-03-10 00:00:00;4351553;9079;3945527;13350;466;90275;2.07
2021-03-11 00:00:00;4360823;9270;3959533;14006;459;90734;2.08
2021-03-12 00:00:00;4370617;9794;3973029;13496;486;91220;2.09
2021-03-13 00:00:00;4380525;9908;3985897;12868;475;91695;2.09
2021-03-14 00:00:00;4390608;10083;3995129;9232;395;92090;2.1
2021-03-15 00:00:00;4400045;9437;4003576;8447;404;92494;2.1
2021-03-16 00:00:00;4409438;9393;4014220;10644;443;92937;2.11
2021-03-17 00:00:00;4418436;8998;4024975;10755;427;93364;2.11
2021-03-18 00:00:00;4428239;9803;4037036;12061;460;93824;2.12
2021-03-19 00:00:00;4437938;9699;4049373;12337;443;94267;2.12
2021-03-20 00:00:00;4447570;9632;4060652;11279;392;94659;2.13
2021-03-21 00:00:00;4456869;9299;4069395;8743;371;95030;2.13
2021-03-22 00:00:00;4466153;9284;4077185;7790;361;95391;2.14
2021-03-23 00:00:00;4474610;8457;4088045;10860;427;95818;2.14
2021-03-24 00:00:00;4483471;8861;4098400;10355;401;96219;2.15
2021-03-25 00:00:00;4492692;9221;4109281;10881;393;96612;2.15
2021-03-26 00:00:00;4501859;9167;4120161;10880;405;97017;2.16
2021-03-27 00:00:00;4510744;8885;4130498;10337;387;97404;2.16
2021-03-28 00:00:00;4519832;9088;4139128;8630;336;97740;2.16
2021-03-29 00:00:00;4528543;8711;4146408;7280;293;98033;2.16
2021-03-30 00:00:00;4536820;8277;4155996;9588;409;98442;2.17
2021-03-31 00:00:00;4545095;8275;4166172;10176;408;98850;2.17
2021-04-01 00:00:00;4554264;9169;4176419;10247;383;99233;2.18
2021-04-02 00:00:00;4563056;8792;4186251;9832;400;99633;2.18
2021-04-03 00:00:00;4572077;9021;4195869;9618;384;100017;2.19
2021-04-04 00:00:00;4580894;8817;4204081;8212;357;100374;2.19
2021-04-05 00:00:00;4589540;8646;4211133;7052;343;100717;2.19
2021-04-06 00:00:00;4597868;8328;4220035;8902;389;101106;2.2
2021-04-07 00:00:00;4606162;8294;4229480;9445;374;101480;2.2
2021-04-08 00:00:00;4614834;8672;4239038;9558;365;101845;2.21
2021-04-09 00:00:00;4623984;9150;4248700;9662;402;102247;2.21
2021-04-10 00:00:00;4632688;8704;4258279;9579;402;102649;2.22
2021-04-11 00:00:00;4641390;8702;4265509;7230;337;102986;2.22
2021-04-12 00:00:00;4649710;8320;4272165;6656;277;103263;2.22
2021-04-13 00:00:00;4657883;8173;4281776;9611;338;103601;2.22
2021-04-14 00:00:00;4666209;8326;4291223;9447;399;104000;2.23
2021-04-15 00:00:00;4675153;8944;4301448;10225;398;104398;2.23
2021-04-16 00:00:00;4684148;8995;4310557;9109;397;104795;2.24
2021-04-17 00:00:00;4693469;9321;4319389;8832;398;105193;2.24
2021-04-18 00:00:00;4702101;8632;4326780;7391;389;105582;2.25
2021-04-19 00:00:00;4710690;8589;4333598;6818;346;105928;2.25
2021-04-20 00:00:00;4718854;8164;4343229;9631;379;106307;2.25
2021-04-21 00:00:00;4727125;8271;4352873;9644;399;106706;2.26
2021-04-22 00:00:00;4736121;8996;4361807;8934;397;107103;2.26
2021-04-23 00:00:00;4744961;8840;4371214;9407;398;107501;2.27
2021-04-24 00:00:00;4753789;8828;4380468;9254;399;107900;2.27
2021-04-25 00:00:00;4762569;8780;4388008;7540;332;108232;2.27
2021-04-26 00:00:00;4771372;8803;4394639;6631;356;108588;2.28
2021-04-27 00:00:00;4779425;8053;4402678;8039;392;108980;2.28
2021-04-28 00:00:00;4787273;7848;4411098;8420;387;109367;2.28
2021-04-29 00:00:00;4796557;9284;4419540;8442;364;109731;2.29
2021-04-30 00:00:00;4805288;8731;4427946;8406;397;110128;2.29
2021-05-01 00:00:00;4814558;9270;4436583;8637;392;110520;2.3
2021-05-02 00:00:00;4823255;8697;4443922;7339;342;110862;2.3
2021-05-03 00:00:00;4831744;8489;4450289;6367;336;111198;2.3
2021-05-04 00:00:00;4839514;7770;4457044;6755;337;111535;2.3
2021-05-05 00:00:00;4847489;7975;4464550;7506;360;111895;2.31
2021-05-06 00:00:00;4855128;7639;4472338;7788;351;112246;2.31
2021-05-07 00:00:00;4863514;8386;4480360;8022;376;112622;2.32
2021-05-08 00:00:00;4871843;8329;4488615;8255;370;112992;2.32
2021-05-09 00:00:00;4880262;8419;4496132;7517;334;113326;2.32
2021-05-10 00:00:00;4888727;8465;4502906;6774;321;113647;2.32
2021-05-11 00:00:00;4896842;8115;4509915;7009;329;113976;2.33
2021-05-12 00:00:00;4905059;8217;4518529;8614;355;114331;2.33
2021-05-13 00:00:00;4913439;8380;4527878;9349;392;114723;2.33
2021-05-14 00:00:00;4922901;9462;4537634;9756;393;115116;2.34
2021-05-15 00:00:00;4931691;8790;4547500;9866;364;115480;2.34
2021-05-16 00:00:00;4940245;8554;4556073;8573;391;115871;2.35
2021-05-17 00:00:00;4949573;9328;4563254;7181;340;116211;2.35
2021-05-18 00:00:00;4957756;8183;4572226;8972;364;116575;2.35
2021-05-19 00:00:00;4965676;7920;4581787;9561;390;116965;2.36
2021-05-20 00:00:00;4974908;9232;4591770;9983;385;117350;2.36
2021-05-21 00:00:00;4983845;8937;4601120;9350;389;117739;2.36
2021-05-22 00:00:00;4992554;8709;4610465;9345;386;118125;2.37
2021-05-23 00:00:00;5001505;8951;4617762;7297;357;118482;2.37
2021-05-24 00:00:00;5009911;8406;4624212;6450;319;118801;2.37
2021-05-25 00:00:00;5017795;7884;4632955;8743;393;119194;2.38
2021-05-26 00:00:00;5026168;8373;4642090;9135;406;119600;2.38
2021-05-27 00:00:00;5035207;9039;4651849;9759;402;120002;2.38
2021-05-28 00:00:00;5044459;9252;4661234;9385;404;120406;2.39
2021-05-29 00:00:00;5053748;9289;4670484;9250;401;120807;2.39
2021-05-30 00:00:00;5063442;9694;4677870;7386;355;121162;2.39
2021-05-31 00:00:00;5071917;8475;4684585;6715;339;121501;2.4
2021-06-01 00:00:00;5081417;9500;4693579;8994;372;121873;2.4
2021-06-02 00:00:00;5090249;8832;4702599;9020;394;122267;2.4
2021-06-03 00:00:00;5099182;8933;4711982;9383;393;122660;2.41
2021-06-04 00:00:00;5108129;8947;4720512;8530;377;123037;2.41
2021-06-05 00:00:00;5117274;9145;4729077;8565;399;123436;2.41
2021-06-06 00:00:00;5126437;9163;4736446;7369;351;123787;2.41
2021-06-07 00:00:00;5135866;9429;4743202;6756;330;124117;2.42
2021-06-08 00:00:00;5145843;9977;4752085;8883;379;124496;2.42
2021-06-09 00:00:00;5156250;10407;4761899;9814;399;124895;2.42
2021-06-10 00:00:00;5167949;11699;4771995;10096;383;125278;2.42
2021-06-11 00:00:00;5180454;12505;4782183;10188;396;125674;2.43
2021-06-12 00:00:00;5193964;13510;4792169;9986;399;126073;2.43
2021-06-13 00:00:00;5208687;14723;4801335;9166;357;126430;2.43
2021-06-14 00:00:00;5222408;13721;4809647;8312;371;126801;2.43
2021-06-15 00:00:00;5236593;14185;4818244;8597;379;127180;2.43
2021-06-16 00:00:00;5249990;13397;4828500;10256;396;127576;2.43
2021-06-17 00:00:00;5264047;14057;4839705;11205;416;127992;2.43
2021-06-18 00:00:00;5281309;17262;4850659;10954;453;128445;2.43
2021-06-19 00:00:00;5299215;17906;4861343;10684;466;128911;2.43
2021-06-20 00:00:00;5316826;17611;4869972;8629;450;129361;2.43
2021-06-21 00:00:00;5334204;17378;4878333;8361;440;129801;2.43
2021-06-22 00:00:00;5350919;16715;4889450;11117;546;130347;2.44
2021-06-23 00:00:00;5368513;17594;4902110;12660;548;130895;2.44
2021-06-24 00:00:00;5388695;20182;4915615;13505;568;131463;2.44
2021-06-25 00:00:00;5409088;20393;4929639;14024;601;132064;2.44
2021-06-26 00:00:00;5430753;21665;4943986;14347;619;132683;2.44
2021-06-27 00:00:00;5451291;20538;4956714;12728;599;133282;2.44
2021-06-28 00:00:00;5472941;21650;4969340;12626;611;133893;2.45
2021-06-29 00:00:00;5493557;20616;4984037;14697;652;134545;2.45
2021-06-30 00:00:00;5514599;21042;5000393;16356;669;135214;2.45
2021-07-01 00:00:00;5538142;23543;5017321;16928;672;135886;2.45
2021-07-02 00:00:00;5561360;23218;5035518;18197;679;136565;2.46
2021-07-03 00:00:00;5585799;24439;5053417;17899;697;137262;2.46
2021-07-04 00:00:00;5610941;25142;5068901;15484;663;137925;2.46
2021-07-05 00:00:00;5635294;24353;5083441;14540;654;138579;2.46
2021-07-06 00:00:00;5658672;23378;5101852;18411;737;139316;2.46
2021-07-07 00:00:00;5682634;23962;5121919;20067;725;140041;2.46
2021-07-08 00:00:00;5707452;24818;5143255;21336;734;140775;2.47
2021-07-09 00:00:00;5733218;25766;5165087;21832;726;141501;2.47
2021-07-10 00:00:00;5758300;25082;5182837;17750;752;142253;2.47
2021-07-11 00:00:00;5783333;25033;5200219;17382;749;143002;2.47
2021-07-12 00:00:00;5808473;25140;5216648;16429;710;143712;2.47
2021-07-13 00:00:00;5833175;24702;5236214;19566;780;144492;2.48
2021-07-14 00:00:00;5857002;23827;5257483;21269;786;145278;2.48
2021-07-15 00:00:00;5882295;25293;5278976;21493;791;146069;2.48
2021-07-16 00:00:00;5907999;25704;5300908;21932;799;146868;2.49
2021-07-17 00:00:00;5933115;25116;5322345;21437;787;147655;2.49
2021-07-18 00:00:00;5958133;25018;5341231;18886;764;148419;2.49
2021-07-19 00:00:00;5982766;24633;5359995;18764;719;149138;2.49
2021-07-20 00:00:00;6006536;23770;5382213;22218;784;149922;2.5
2021-07-21 00:00:00;6030240;23704;5404797;22584;783;150705;2.5
2021-07-22 00:00:00;6054711;24471;5427457;22660;796;151501;2.5
2021-07-23 00:00:00;6078522;23811;5450004;22547;795;152296;2.51
2021-07-24 00:00:00;6102469;23947;5471956;21952;799;153095;2.51
2021-07-25 00:00:00;6126541;24072;5490634;18678;779;153874;2.51
2021-07-26 00:00:00;6149780;23239;5506834;16200;727;154601;2.51
2021-07-27 00:00:00;6172812;23032;5526950;20116;779;155380;2.52
2021-07-28 00:00:00;6195232;22420;5547529;20579;798;156178;2.52
2021-07-29 00:00:00;6218502;23270;5568363;20834;799;156977;2.52
2021-07-30 00:00:00;6242066;23564;5588848;20485;794;157771;2.53
2021-07-31 00:00:00;6265873;23807;5608619;19771;792;158563;2.53
2021-08-01 00:00:00;6288677;22804;5625890;17271;789;159352;2.53
2021-08-02 00:00:00;6312185;23508;5640783;14893;785;160137;2.54
2021-08-03 00:00:00;6334195;22010;5659746;18963;788;160925;2.54
2021-08-04 00:00:00;6356784;22589;5679842;20096;790;161715;2.54
2021-08-05 00:00:00;6379904;23120;5700212;20370;794;162509;2.55
2021-08-06 00:00:00;6402564;22660;5720353;20141;792;163301;2.55
2021-08-07 00:00:00;6424884;22320;5739838;19485;793;164094;2.55
2021-08-08 00:00:00;6447750;22866;5755507;15669;787;164881;2.56
2021-08-09 00:00:00;6469910;22160;5769981;14474;769;165650;2.56
2021-08-10 00:00:00;6491288;21378;5788710;18729;792;166442;2.56
2021-08-11 00:00:00;6512859;21571;5808777;20067;799;167241;2.57
2021-08-12 00:00:00;6534791;21932;5828972;20195;808;168049;2.57
2021-08-13 00:00:00;6557068;22277;5848340;19368;815;168864;2.58
2021-08-14 00:00:00;6579212;22144;5867890;19550;819;169683;2.58
2021-08-15 00:00:00;6600836;21624;5884316;16426;816;170499;2.58
2021-08-16 00:00:00;6621601;20765;5899917;15601;806;171305;2.59
2021-08-17 00:00:00;6642559;20958;5918324;18407;805;172110;2.59
2021-08-18 00:00:00;6663473;20914;5939037;20713;799;172909;2.59
2021-08-19 00:00:00;6684531;21058;5963054;24017;791;173700;2.6
2021-08-20 00:00:00;6705523;20992;5983405;20351;785;174485;2.6
2021-08-21 00:00:00;6726523;21000;6004052;20647;797;175282;2.61
2021-08-22 00:00:00;6747087;20564;6019466;15414;762;176044;2.61
2021-08-23 00:00:00;6766541;19454;6034867;15401;776;176820;2.61
2021-08-24 00:00:00;6785374;18833;6053503;18636;794;177614;2.62
2021-08-25 00:00:00;6804910;19536;6073157;19654;809;178423;2.62
2021-08-26 00:00:00;6824540;19630;6092818;19661;820;179243;2.63
2021-08-27 00:00:00;6844049;19509;6112035;19217;798;180041;2.63
2021-08-28 00:00:00;6863541;19492;6131446;19411;799;180840;2.63
2021-08-29 00:00:00;6882827;19286;6148250;16804;797;181637;2.64
2021-08-30 00:00:00;6901152;18325;6162430;14180;792;182429;2.64
2021-08-31 00:00:00;6918965;17813;6181054;18624;795;183224;2.65
2021-09-01 00:00:00;6937333;18368;6199379;18325;790;184014;2.65
2021-09-02 00:00:00;6956318;18985;6218048;18669;798;184812;2.66
2021-09-03 00:00:00;6975174;18856;6236738;18690;799;185611;2.66
2021-09-04 00:00:00;6993954;18780;6255475;18737;796;186407;2.67
2021-09-05 00:00:00;7012599;18645;6270731;15256;793;187200;2.67
2021-09-06 00:00:00;7030455;17856;6285007;14276;790;187990;2.67
2021-09-07 00:00:00;7047880;17425;6302250;17243;795;188785;2.68
2021-09-08 00:00:00;7065904;18024;6320512;18262;797;189582;2.68
2021-09-09 00:00:00;7084284;18380;6340151;19639;794;190376;2.69
2021-09-10 00:00:00;7102625;18341;6357272;17121;789;191165;2.69
2021-09-11 00:00:00;7121516;18891;6375160;17888;796;191961;2.7
2021-09-12 00:00:00;7140070;18554;6389657;14497;788;192749;2.7
2021-09-13 00:00:00;7158248;18178;6402126;12469;719;193468;2.7
2021-09-14 00:00:00;7176085;17837;6418033;15907;781;194249;2.71
2021-09-15 00:00:00;7194926;18841;6435072;17039;792;195041;2.71
2021-09-16 00:00:00;7214520;19594;6452398;17326;794;195835;2.71
2021-09-17 00:00:00;7234425;19905;6469017;16619;791;196626;2.72
2021-09-18 00:00:00;7254754;20329;6485264;16247;799;197425;2.72
2021-09-19 00:00:00;7274928;20174;6498682;13418;793;198218;2.72
2021-09-20 00:00:00;7294672;19744;6510674;11992;778;198996;2.73
2021-09-21 00:00:00;7313851;19179;6526111;15437;812;199808;2.73
2021-09-22 00:00:00;7333557;19706;6542213;16102;817;200625;2.74
2021-09-23 00:00:00;7354995;21438;6558780;16567;820;201445;2.74
2021-09-24 00:00:00;7376374;21379;6574608;15828;828;202273;2.74
2021-09-25 00:00:00;7398415;22041;6590933;16325;822;203095;2.75
2021-09-26 00:00:00;7420913;22498;6604604;13671;805;203900;2.75
2021-09-27 00:00:00;7443149;22236;6618117;13513;779;204679;2.75
2021-09-28 00:00:00;7464708;21559;6635485;17368;852;205531;2.75
2021-09-29 00:00:00;7487138;22430;6653941;18456;857;206388;2.76
2021-09-30 00:00:00;7511026;23888;6672767;18826;867;207255;2.76
2021-10-01 00:00:00;7535548;24522;6692722;19955;887;208142;2.76
2021-10-02 00:00:00;7560767;25219;6710574;17852;886;209028;2.76
2021-10-03 00:00:00;7586536;25769;6725965;15391;890;209918;2.77
2021-10-04 00:00:00;7612317;25781;6740491;14526;883;210801;2.77
2021-10-05 00:00:00;7637427;25110;6759059;18568;895;211696;2.77
2021-10-06 00:00:00;7662560;25133;6778900;19841;929;212625;2.77
2021-10-07 00:00:00;7690110;27550;6799230;20330;924;213549;2.78
2021-10-08 00:00:00;7717356;27246;6819796;20566;936;214485;2.78
2021-10-09 00:00:00;7746718;29362;6840845;21049;968;215453;2.78
2021-10-10 00:00:00;7775365;28647;6858119;17274;962;216415;2.78
2021-10-11 00:00:00;7804774;29409;6873579;15460;957;217372;2.79
2021-10-12 00:00:00;7832964;28190;6894285;20706;973;218345;2.79
2021-10-13 00:00:00;7861681;28717;6916086;21801;984;219329;2.79
2021-10-14 00:00:00;7892980;31299;6937756;21670;985;220314;2.79
2021-10-15 00:00:00;7925176;32196;6960024;22268;999;221313;2.79
2021-10-16 00:00:00;7958384;33208;6981907;21883;1002;222315;2.79
2021-10-17 00:00:00;7992687;34303;7000624;18717;997;223312;2.79
2021-10-18 00:00:00;8027012;34325;7017055;16431;998;224310;2.79
2021-10-19 00:00:00;8060752;33740;7040481;23426;1015;225325;2.8
2021-10-20 00:00:00;8094825;34073;7065712;25231;1028;226353;2.8
2021-10-21 00:00:00;8131164;36339;7091607;25895;1036;227389;2.8
2021-10-22 00:00:00;8168305;37141;7117060;25453;1064;228453;2.8
2021-10-23 00:00:00;8205983;37678;7143137;26077;1075;229528;2.8
2021-10-24 00:00:00;8241643;35660;7165921;22784;1072;230600;2.8
2021-10-25 00:00:00;8279573;37930;7186611;20690;1069;231669;2.8
2021-10-26 00:00:00;8316019;36446;7213584;26973;1106;232775;2.8
2021-10-27 00:00:00;8352601;36582;7242735;29151;1123;233898;2.8
2021-10-28 00:00:00;8392697;40096;7272053;29318;1159;235057;2.8
2021-10-29 00:00:00;8432546;39849;7302515;30462;1163;236220;2.8
2021-10-30 00:00:00;8472797;40251;7331424;28909;1160;237380;2.8
2021-10-31 00:00:00;8513790;40993;7358539;27115;1158;238538;2.8
2021-11-01 00:00:00;8554192;40402;7381726;23187;1155;239693;2.8
2021-11-02 00:00:00;8593200;39008;7412631;30905;1178;240871;2.8
2021-11-03 00:00:00;8633643;40443;7445438;32807;1189;242060;2.8
2021-11-04 00:00:00;8673860;40217;7477366;31928;1195;243255;2.8
2021-11-05 00:00:00;8714595;40735;7505971;28605;1192;244447;2.81
2021-11-06 00:00:00;8755930;41335;7535172;29201;1188;245635;2.81
2021-11-07 00:00:00;8795095;39165;7561978;26806;1179;246814;2.81
2021-11-08 00:00:00;8834495;39400;7587560;25582;1190;248004;2.81
2021-11-09 00:00:00;8873655;39160;7619596;32036;1211;249215;2.81
2021-11-10 00:00:00;8911713;38058;7654161;34565;1239;250454;2.81
2021-11-11 00:00:00;8952472;40759;7687317;33156;1237;251691;2.81
2021-11-12 00:00:00;8992595;40123;7720962;33645;1235;252926;2.81
2021-11-13 00:00:00;9031851;39256;7754764;33802;1241;254167;2.81
2021-11-14 00:00:00;9070674;38823;7784585;29821;1219;255386;2.82
2021-11-15 00:00:00;9109094;38420;7812287;27702;1211;256597;2.82
2021-11-16 00:00:00;9145912;36818;7846448;34161;1240;257837;2.82
2021-11-17 00:00:00;9182538;36626;7882836;36388;1247;259084;2.82
2021-11-18 00:00:00;9219912;37374;7919250;36414;1251;260335;2.82
2021-11-19 00:00:00;9257068;37156;7956254;37004;1254;261589;2.83
2021-11-20 00:00:00;9294188;37120;7992426;36172;1254;262843;2.83
2021-11-21 00:00:00;9331158;36970;8024930;32504;1252;264095;2.83
2021-11-22 00:00:00;9366839;35681;8053643;28713;1241;265336;2.83
2021-11-23 00:00:00;9400835;33996;8089694;36051;1243;266579;2.84
2021-11-24 00:00:00;9434393;33558;8126376;36682;1240;267819;2.84
2021-11-25 00:00:00;9468189;33796;8164826;38450;1238;269057;2.84
2021-11-26 00:00:00;9502879;34690;8200971;36145;1235;270292;2.84
2021-11-27 00:00:00;9536825;33946;8237465;36494;1239;271531;2.85
2021-11-28 00:00:00;9570373;33548;8268111;30646;1224;272755;2.85
2021-11-29 00:00:00;9604233;33860;8295811;27700;1209;273964;2.85
2021-11-30 00:00:00;9636881;32648;8329253;33442;1229;275193;2.86
2021-12-01 00:00:00;9669718;32837;8364932;35679;1226;276419;2.86
2021-12-02 00:00:00;9703107;33389;8400117;35185;1221;277640;2.86
2021-12-03 00:00:00;9736037;32930;8436631;36514;1217;278857;2.86
2021-12-04 00:00:00;9769011;32974;8471813;35182;1215;280072;2.87
2021-12-05 00:00:00;9801613;32602;8502406;30593;1206;281278;2.87
2021-12-06 00:00:00;9833749;32136;8530476;28070;1184;282462;2.87
2021-12-07 00:00:00;9864845;31096;8565091;34615;1182;283644;2.88
2021-12-08 00:00:00;9895597;30752;8602067;36976;1179;284823;2.88
2021-12-09 00:00:00;9925806;30209;8637861;35794;1181;286004;2.88
2021-12-10 00:00:00;9956679;30873;8673518;35657;1176;287180;2.88
2021-12-11 00:00:00;9986967;30288;8709964;36446;1171;288351;2.89
2021-12-12 00:00:00;10016896;29929;8741355;31391;1132;289483;2.89
2021-12-13 00:00:00;10046454;29558;8769916;28561;1121;290604;2.89
2021-12-14 00:00:00;10074797;28343;8804000;34084;1145;291749;2.9
2021-12-15 00:00:00;10103160;28363;8839633;35633;1142;292891;2.9
2021-12-16 00:00:00;10131646;28486;8876788;37155;1133;294024;2.9
2021-12-17 00:00:00;10159389;27743;8914225;37437;1080;295104;2.9
2021-12-18 00:00:00;10186823;27434;8952266;38041;1076;296180;2.91
2021-12-19 00:00:00;10214790;27967;8984921;32655;1023;297203;2.91
2021-12-20 00:00:00;10241812;27022;9014980;30059;1019;298222;2.91
2021-12-21 00:00:00;10267719;25907;9055199;40219;1027;299249;2.91
2021-12-22 00:00:00;10292983;25264;9097521;42322;1020;300269;2.92
2021-12-23 00:00:00;10318650;25667;9139166;41645;1002;301271;2.92
2021-12-24 00:00:00;10343353;24703;9180379;41213;998;302269;2.92
2021-12-25 00:00:00;10368299;24946;9222486;42107;981;303250;2.92
2021-12-26 00:00:00;10392020;23721;9259771;37285;968;304218;2.93
2021-12-27 00:00:00;10415230;23210;9293486;33715;937;305155;2.93
2021-12-28 00:00:00;10437152;21922;9337447;43961;935;306090;2.93
2021-12-29 00:00:00;10458271;21119;9380223;42776;932;307022;2.94
2021-12-30 00:00:00;10479344;21073;9423227;43004;926;307948;2.94
2021-12-31 00:00:00;10499982;20638;9463919;40692;912;308860;2.94
2022-01-01 00:00:00;10519733;19751;9497063;33144;847;309707;2.94
2022-01-02 00:00:00;10537966;18233;9524039;26976;811;310518;2.95
2022-01-03 00:00:00;10554309;16343;9548076;24037;835;311353;2.95
2022-01-04 00:00:00;10570212;15903;9575147;27071;834;312187;2.95
2022-01-05 00:00:00;10585984;15772;9600728;25581;828;313015;2.96
2022-01-06 00:00:00;10601300;15316;9623677;22949;802;313817;2.96
2022-01-07 00:00:00;10618035;16735;9645712;22035;787;314604;2.96
2022-01-08 00:00:00;10634603;16568;9666161;20449;796;315400;2.97
2022-01-09 00:00:00;10650849;16246;9686912;20751;763;316163;2.97
2022-01-10 00:00:00;10666679;15830;9706802;19890;741;316904;2.97
2022-01-11 00:00:00;10684204;17525;9732018;25216;783;317687;2.97
2022-01-12 00:00:00;10702150;17946;9758364;26346;745;318432;2.98
2022-01-13 00:00:00;10723305;21155;9784348;25984;740;319172;2.98
2022-01-14 00:00:00;10747125;23820;9809300;24952;739;319911;2.98
2022-01-15 00:00:00;10774304;27179;9835884;26584;723;320634;2.98
2022-01-16 00:00:00;10803534;29230;9858615;22731;686;321320;2.97
2022-01-17 00:00:00;10834260;30726;9878371;19756;670;321990;2.97
2022-01-18 00:00:00;10865512;31252;9902935;24564;688;322678;2.97
2022-01-19 00:00:00;10899411;33899;9925855;22920;698;323376;2.97
2022-01-20 00:00:00;10938261;38850;9950333;24478;684;324060;2.96
2022-01-21 00:00:00;10987774;49513;9975052;24719;692;324752;2.96
2022-01-22 00:00:00;11044986;57212;10000577;25525;681;325433;2.95
2022-01-23 00:00:00;11108191;63205;10023622;23045;679;326112;2.94
2022-01-24 00:00:00;11173300;65109;10045336;21714;655;326767;2.92
2022-01-25 00:00:00;11241109;67809;10071740;26404;681;327448;2.91
2022-01-26 00:00:00;11315801;74692;10099937;28197;657;328105;2.9
2022-01-27 00:00:00;11404617;88816;10129691;29754;665;328770;2.88
2022-01-28 00:00:00;11502657;98040;10159197;29506;673;329443;2.86
2022-01-29 00:00:00;11615779;113122;10189207;30010;668;330111;2.84
2022-01-30 00:00:00;11737007;121228;10218151;28944;617;330728;2.82
2022-01-31 00:00:00;11861077;124070;10248281;30130;621;331349;2.79
2022-02-01 00:00:00;11986913;125836;10288582;40301;663;332012;2.77
2022-02-02 00:00:00;12128796;141883;10337008;48426;678;332690;2.74
2022-02-03 00:00:00;12284564;155768;10390732;53724;667;333357;2.71
2022-02-04 00:00:00;12452765;168201;10449181;58449;682;334039;2.68
2022-02-05 00:00:00;12630047;177282;10509688;60507;714;334753;2.65
2022-02-06 00:00:00;12810118;180071;10569271;59583;661;335414;2.62
2022-02-07 00:00:00;12982023;171905;10624954;55683;609;336023;2.59
2022-02-08 00:00:00;13147666;165643;10706142;81188;698;336721;2.56
2022-02-09 00:00:00;13330769;183103;10803305;97163;669;337390;2.53
2022-02-10 00:00:00;13527845;197076;10909397;106092;701;338091;2.5
2022-02-11 00:00:00;13731794;203949;11021633;112236;722;338813;2.47
2022-02-12 00:00:00;13935560;203766;11134291;112658;729;339542;2.44
2022-02-13 00:00:00;14133509;197949;11235859;101568;706;340248;2.41
2022-02-14 00:00:00;14313965;180456;11333044;97185;683;340931;2.38
2022-02-15 00:00:00;14480596;166631;11470925;137881;704;341635;2.36
2022-02-16 00:00:00;14659880;179284;11643393;172468;748;342383;2.34
2022-02-17 00:00:00;14840502;180622;11828475;185082;790;343173;2.31
2022-02-18 00:00:00;15020573;180071;12026844;198369;784;343957;2.29
2022-02-19 00:00:00;15199720;179147;12217942;191098;798;344755;2.27
2022-02-20 00:00:00;15370419;170699;12365238;147296;745;345500;2.25
2022-02-21 00:00:00;15522756;152337;12492732;127494;735;346235;2.23
2022-02-22 00:00:00;15657928;135172;12657025;164293;796;347031;2.22
2022-02-23 00:00:00;15795570;137642;12836228;179203;785;347816;2.2
2022-02-24 00:00:00;15928568;132998;12972661;136433;762;348578;2.19
2022-02-25 00:00:00;16052028;123460;13139971;167310;787;349365;2.18
2022-02-26 00:00:00;16175023;122995;13321314;181343;793;350158;2.16
2022-02-27 00:00:00;16291116;116093;13458910;137596;769;350927;2.15
2022-02-28 00:00:00;16398036;106920;13575652;116742;733;351660;2.14
2022-03-01 00:00:00;16495369;97333;13748465;172813;786;352446;2.14
2022-03-02 00:00:00;16592824;97455;13931995;183530;784;353230;2.13
2022-03-03 00:00:00;16685850;93026;14102684;170689;781;354011;2.12
2022-03-04 00:00:00;16775024;89174;14263191;160507;776;354787;2.11
2022-03-05 00:00:00;16861793;86769;14418916;155725;750;355537;2.11
2022-03-06 00:00:00;16941656;79863;14567976;149060;744;356281;2.1
2022-03-07 00:00:00;17014818;73162;14690595;122619;671;356952;2.1
2022-03-08 00:00:00;17081394;66576;14802351;111756;649;357601;2.09
2022-03-09 00:00:00;17140069;58675;14895083;92732;645;358246;2.09
2022-03-10 00:00:00;17191300;51231;15043717;148634;665;358911;2.09
2022-03-11 00:00:00;17242043;50743;15194927;151210;674;359585;2.09
2022-03-12 00:00:00;17290197;48154;15351778;156851;630;360215;2.08
2022-03-13 00:00:00;17335186;44989;15480407;128629;596;360811;2.08
2022-03-14 00:00:00;17376241;41055;15585650;105243;533;361344;2.08
2022-03-15 00:00:00;17412919;36678;15704022;118372;558;361902;2.08
2022-03-16 00:00:00;17449438;36519;15822031;118009;576;362478;2.08
2022-03-17 00:00:00;17484257;34819;15934645;112614;561;363039;2.08
2022-03-18 00:00:00;17518699;34442;16039709;105064;524;363563;2.08
2022-03-19 00:00:00;17551657;32958;16135267;95558;495;364058;2.07
2022-03-20 00:00:00;17582692;31035;16209942;74675;434;364492;2.07
2022-03-21 00:00:00;17611401;28709;16271880;61938;409;364901;2.07
2022-03-22 00:00:00;17637795;26394;16346800;74920;472;365373;2.07
2022-03-23 00:00:00;17664621;26826;16417422;70622;429;365802;2.07
2022-03-24 00:00:00;17690008;25387;16483898;66476;418;366220;2.07
2022-03-25 00:00:00;17715390;25382;16545758;61860;398;366618;2.07
2022-03-26 00:00:00;17739462;24072;16606691;60933;395;367013;2.07
2022-03-27 00:00:00;17762742;23280;16654231;47540;338;367351;2.07
2022-03-28 00:00:00;17783843;21101;16689977;35746;335;367686;2.07
2022-03-29 00:00:00;17803503;19660;16737206;47229;339;368025;2.07
2022-03-30 00:00:00;17823648;20145;16788291;51085;352;368377;2.07
2022-03-31 00:00:00;17842925;19277;16838787;50496;345;368722;2.07
2022-04-01 00:00:00;17862089;19164;16884785;45998;342;369064;2.07
2022-04-02 00:00:00;17880038;17949;16929332;44547;340;369404;2.07
2022-04-03 00:00:00;17896866;16828;16965027;35695;304;369708;2.07
2022-04-04 00:00:00;17912157;15291;16997877;32850;287;369995;2.07
2022-04-05 00:00:00;17926104;13947;17035336;37459;316;370311;2.07
2022-04-06 00:00:00;17940765;14661;17070642;35306;291;370602;2.07
2022-04-07 00:00:00;17955120;14355;17105946;35304;287;370889;2.07
2022-04-08 00:00:00;17969431;14311;17143630;37684;280;371169;2.07
2022-04-09 00:00:00;17983004;13573;17183730;40100;288;371457;2.07
2022-04-10 00:00:00;17996060;13056;17213102;29372;259;371716;2.07
2022-04-11 00:00:00;18007915;11855;17239857;26755;248;371964;2.07
2022-04-12 00:00:00;18018825;10910;17271128;31271;281;372245;2.07
2022-04-13 00:00:00;18030579;11754;17299263;28135;267;372512;2.07
2022-04-14 00:00:00;18041927;11348;17321116;21853;254;372766;2.07
2022-04-15 00:00:00;18053359;11432;17340639;19523;261;373027;2.07
2022-04-16 00:00:00;18064454;11095;17359645;19006;240;373267;2.07
2022-04-17 00:00:00;18074717;10263;17376141;16496;233;373500;2.07
2022-04-18 00:00:00;18084151;9434;17390465;14324;213;373713;2.07
2022-04-19 00:00:00;18092791;8640;17407228;16763;235;373948;2.07
2022-04-20 00:00:00;18101986;9195;17423428;16200;223;374171;2.07
2022-04-21 00:00:00;18110861;8875;17437610;14182;197;374368;2.07
2022-04-22 00:00:00;18119862;9001;17451090;13480;195;374563;2.07
2022-04-23 00:00:00;18128691;8829;17464120;13030;171;374734;2.07
2022-04-24 00:00:00;18137137;8446;17474628;10508;168;374902;2.07
2022-04-25 00:00:00;18144788;7651;17483483;8855;159;375061;2.07
2022-04-26 00:00:00;18151895;7107;17495382;11899;176;375237;2.07
2022-04-27 00:00:00;18159600;7705;17506859;11477;163;375400;2.07
2022-04-28 00:00:00;18167281;7681;17517922;11063;166;375566;2.07
2022-04-29 00:00:00;18174991;7710;17528963;11041;161;375727;2.07
2022-04-30 00:00:00;18182354;7363;17539985;11022;157;375884;2.07
2022-05-01 00:00:00;18189401;7047;17548718;8733;147;376031;2.07
2022-05-02 00:00:00;18195608;6207;17556220;7502;136;376167;2.07
2022-05-03 00:00:00;18201074;5466;17563272;7052;125;376292;2.07
2022-05-04 00:00:00;18206167;5093;17569936;6664;129;376421;2.07
2022-05-05 00:00:00;18211178;5011;17578659;8723;139;376560;2.07
2022-05-06 00:00:00;18216719;5541;17588067;9408;136;376696;2.07
2022-05-07 00:00:00;18222219;5500;17596716;8649;132;376828;2.07
2022-05-08 00:00:00;18227666;5447;17603398;6682;118;376946;2.07
2022-05-09 00:00:00;18232696;5030;17609357;5959;103;377049;2.07
2022-05-10 00:00:00;18237227;4531;17614371;5014;101;377150;2.07
2022-05-11 00:00:00;18241329;4102;17619414;5043;98;377248;2.07
2022-05-12 00:00:00;18245394;4065;17626344;6930;111;377359;2.07
2022-05-13 00:00:00;18250290;4896;17633601;7257;105;377464;2.07
2022-05-14 00:00:00;18255337;5047;17640979;7378;107;377571;2.07
2022-05-15 00:00:00;18260293;4956;17647179;6200;99;377670;2.07
2022-05-16 00:00:00;18264836;4543;17652558;5379;89;377759;2.07
2022-05-17 00:00:00;18268958;4122;17658542;5984;110;377869;2.07
2022-05-18 00:00:00;18273690;4732;17664676;6134;106;377975;2.07
2022-05-19 00:00:00;18278617;4927;17670628;5952;97;378072;2.07
2022-05-20 00:00:00;18283706;5089;17676801;6173;96;378168;2.07
2022-05-21 00:00:00;18288740;5034;17683089;6288;102;378270;2.07
2022-05-22 00:00:00;18293450;4710;17688903;5814;80;378350;2.07
2022-05-23 00:00:00;18297608;4158;17694020;5117;76;378426;2.07
2022-05-24 00:00:00;18301393;3785;17700372;6352;90;378516;2.07
2022-05-25 00:00:00;18305973;4580;17707077;6705;93;378609;2.07
2022-05-26 00:00:00;18310673;4700;17713532;6455;91;378700;2.07
2022-05-27 00:00:00;18315292;4619;17719596;6064;84;378784;2.07
2022-05-28 00:00:00;18319848;4556;17725440;5844;86;378870;2.07
2022-05-29 00:00:00;18324036;4188;17729851;4411;85;378955;2.07
2022-05-30 00:00:00;18327837;3801;17733870;4019;74;379029;2.07
2022-05-31 00:00:00;18331363;3526;17739356;5486;88;379117;2.07
2022-06-01 00:00:00;18335514;4151;17744984;5628;83;379200;2.07
2022-06-02 00:00:00;18339776;4262;17749960;4976;85;379285;2.07
2022-06-03 00:00:00;18343964;4188;17755194;5234;78;379363;2.07
2022-06-04 00:00:00;18348065;4101;17760326;5132;82;379445;2.07
2022-06-05 00:00:00;18351851;3786;17764261;3935;75;379520;2.07
2022-06-06 00:00:00;18355200;3349;17767753;3492;64;379584;2.07
2022-06-07 00:00:00;18358459;3259;17772888;5135;73;379657;2.07
2022-06-08 00:00:00;18362105;3646;17777625;4737;79;379736;2.07
2022-06-09 00:00:00;18365879;3774;17781922;4297;77;379813;2.07
2022-06-10 00:00:00;18369557;3678;17786254;4332;70;379883;2.07
2022-06-11 00:00:00;18373184;3627;17791081;4827;72;379955;2.07
2022-06-12 00:00:00;18376587;3403;17794561;3480;65;380020;2.07
2022-06-13 00:00:00;18379583;2996;17798245;3684;56;380076;2.07
2022-06-14 00:00:00;18382380;2797;17801569;3324;61;380137;2.07
2022-06-15 00:00:00;18385098;2718;17806097;4528;66;380203;2.07
2022-06-16 00:00:00;18388424;3326;17810796;4699;67;380270;2.07
2022-06-17 00:00:00;18391797;3373;17815024;4228;63;380333;2.07
2022-06-18 00:00:00;18395179;3382;17819395;4371;68;380401;2.07
2022-06-19 00:00:00;18398260;3081;17822674;3279;62;380463;2.07
2022-06-20 00:00:00;18400927;2667;17825397;2723;54;380517;2.07
2022-06-21 00:00:00;18403427;2500;17828837;3440;60;380577;2.07
2022-06-22 00:00:00;18406485;3058;17832604;3767;66;380643;2.07
2022-06-23 00:00:00;18409651;3166;17836121;3517;68;380711;2.07
2022-06-24 00:00:00;18412805;3154;17839346;3225;65;380776;2.07
2022-06-25 00:00:00;18415877;3072;17842800;3454;61;380837;2.07
2022-06-26 00:00:00;18418881;3004;17845513;2713;55;380892;2.07
2022-06-27 00:00:00;18421564;2683;17847868;2355;51;380943;2.07
2022-06-28 00:00:00;18424105;2541;17851282;3414;59;381002;2.07
2022-06-29 00:00:00;18427133;3028;17854962;3680;54;381056;2.07
2022-06-30 00:00:00;18430239;3106;17858217;3255;56;381112;2.07
2022-07-01 00:00:00;18433394;3155;17861605;3388;53;381165;2.07
2022-07-02 00:00:00;18436679;3285;17865093;3488;51;381216;2.07
2022-07-03 00:00:00;18439759;3080;17867688;2595;47;381263;2.07
2022-07-04 00:00:00;18442625;2866;17869964;2276;43;381306;2.07
2022-07-05 00:00:00;18445301;2676;17873576;3612;48;381354;2.07
2022-07-06 00:00:00;18448451;3150;17877013;3437;44;381398;2.07
2022-07-07 00:00:00;18451810;3359;17880191;3178;52;381450;2.07
2022-07-08 00:00:00;18455274;3464;17882978;2787;49;381499;2.07
2022-07-09 00:00:00;18458813;3539;17886064;3086;45;381544;2.07
2022-07-10 00:00:00;18462211;3398;17888560;2496;39;381583;2.07
2022-07-11 00:00:00;18465308;3097;17890856;2296;38;381621;2.07
2022-07-12 00:00:00;18468310;3002;17894065;3209;48;381669;2.07
2022-07-13 00:00:00;18472239;3929;17897428;3363;42;381711;2.07
2022-07-14 00:00:00;18476477;4238;17900518;3090;43;381754;2.07
2022-07-15 00:00:00;18480934;4457;17903447;2929;40;381794;2.07
2022-07-16 00:00:00;18485632;4698;17906326;2879;41;381835;2.07
2022-07-17 00:00:00;18490296;4664;17908809;2483;46;381881;2.07
2022-07-18 00:00:00;18494844;4548;17911340;2531;35;381916;2.06
2022-07-19 00:00:00;18499044;4200;17915526;4186;44;381960;2.06
2022-07-20 00:00:00;18504729;5685;17919843;4317;37;381997;2.06
2022-07-21 00:00:00;18511120;6391;17924372;4529;42;382039;2.06
2022-07-22 00:00:00;18517779;6659;17929059;4687;41;382080;2.06
2022-07-23 00:00:00;18524732;6953;17933862;4803;38;382118;2.06
2022-07-24 00:00:00;18532255;7523;17938674;4812;37;382155;2.06
2022-07-25 00:00:00;18538826;6571;17942908;4234;34;382189;2.06
2022-07-26 00:00:00;18545009;6183;17948330;5422;47;382236;2.06
2022-07-27 00:00:00;18554036;9027;17953445;5115;36;382272;2.06
2022-07-28 00:00:00;18565551;11515;17958463;5018;41;382313;2.06
2022-07-29 00:00:00;18576973;11422;17963133;4670;39;382352;2.06
2022-07-30 00:00:00;18589221;12248;17969342;6209;43;382395;2.06
2022-07-31 00:00:00;18601719;12498;17975398;6056;38;382433;2.06
2022-08-01 00:00:00;18612543;10824;17981475;6077;36;382469;2.05
2022-08-02 00:00:00;18622103;9560;17990048;8573;48;382517;2.05
2022-08-03 00:00:00;18636741;14638;18000314;10266;43;382560;2.05
2022-08-04 00:00:00;18653867;17126;18010066;9752;44;382604;2.05
2022-08-05 00:00:00;18672422;18555;18019883;9817;47;382651;2.05
2022-08-06 00:00:00;18692396;19974;18030626;10743;46;382697;2.05
2022-08-07 00:00:00;18712699;20303;18039355;8729;44;382741;2.05
2022-08-08 00:00:00;18730561;17862;18048076;8721;45;382786;2.04
2022-08-09 00:00:00;18746886;16325;18061168;13092;60;382846;2.04
2022-08-10 00:00:00;18770657;23771;18075720;14552;56;382902;2.04
2022-08-11 00:00:00;18796472;25815;18089941;14221;52;382954;2.04
2022-08-12 00:00:00;18824282;27810;18104261;14320;57;383011;2.03
2022-08-13 00:00:00;18852976;28694;18121135;16874;60;383071;2.03
2022-08-14 00:00:00;18881958;28982;18136077;14942;54;383125;2.03
2022-08-15 00:00:00;18907231;25273;18151487;15410;53;383178;2.03
2022-08-16 00:00:00;18931140;23909;18172070;20583;59;383237;2.02
2022-08-17 00:00:00;18964246;33106;18194750;22680;63;383300;2.02
2022-08-18 00:00:00;19000055;35809;18216241;21491;62;383362;2.02
2022-08-19 00:00:00;19037664;37609;18238128;21887;65;383427;2.01
2022-08-20 00:00:00;19077674;40010;18262350;24222;69;383496;2.01
2022-08-21 00:00:00;19117343;39669;18284586;22236;64;383560;2.01
2022-08-22 00:00:00;19150404;33061;18306867;22281;57;383617;2
2022-08-23 00:00:00;19181371;30967;18337736;30869;69;383686;2
2022-08-24 00:00:00;19221602;40231;18370612;32876;72;383758;2
2022-08-25 00:00:00;19265521;43919;18401387;30775;71;383829;1.99
2022-08-26 00:00:00;19311973;46452;18435096;33709;81;383910;1.99
2022-08-27 00:00:00;19359066;47093;18467738;32642;90;384000;1.98
2022-08-28 00:00:00;19405923;46857;18495961;28223;83;384083;1.98
2022-08-29 00:00:00;19445581;39658;18520851;24890;77;384160;1.98
2022-08-30 00:00:00;19482648;37067;18557580;36729;94;384254;1.97
2022-08-31 00:00:00;19528969;46321;18596634;39054;92;384346;1.97
2022-09-01 00:00:00;19578730;49761;18635574;38940;95;384441;1.96
2022-09-02 00:00:00;19629682;50952;18672586;37012;91;384532;1.96
2022-09-03 00:00:00;19681381;51699;18710966;38380;92;384624;1.95
2022-09-04 00:00:00;19729423;48042;18746698;35732;87;384711;1.95
2022-09-05 00:00:00;19771113;41690;18777401;30703;76;384787;1.95
2022-09-06 00:00:00;19809613;38500;18823705;46304;95;384882;1.94
2022-09-07 00:00:00;19857571;47958;18876316;52611;94;384976;1.94
2022-09-08 00:00:00;19908189;50618;18926609;50293;93;385069;1.93
2022-09-09 00:00:00;19960295;52106;18977695;51086;96;385165;1.93
2022-09-10 00:00:00;20013781;53486;19023718;46023;97;385262;1.92
2022-09-11 00:00:00;20066610;52829;19061006;37288;86;385348;1.92
2022-09-12 00:00:00;20113098;46488;19096666;35660;81;385429;1.92
2022-09-13 00:00:00;20157143;44045;19144853;48187;101;385530;1.91
2022-09-14 00:00:00;20208878;51735;19195104;50251;98;385628;1.91
2022-09-15 00:00:00;20265004;56126;19244856;49752;99;385727;1.9
2022-09-16 00:00:00;20324039;59035;19294876;50020;110;385837;1.9
2022-09-17 00:00:00;20382344;58305;19344838;49962;107;385944;1.89
2022-09-18 00:00:00;20439095;56751;19387036;42198;101;386045;1.89
2022-09-19 00:00:00;20488583;49488;19425631;38595;91;386136;1.88
2022-09-20 00:00:00;20535057;46474;19477825;52194;98;386234;1.88
2022-09-21 00:00:00;20588102;53045;19537543;59718;107;386341;1.88
2022-09-22 00:00:00;20641559;53457;19594562;57019;106;386447;1.87
2022-09-23 00:00:00;20694894;53335;19652187;57625;104;386551;1.87
2022-09-24 00:00:00;20746163;51269;19710599;58412;111;386662;1.86
2022-09-25 00:00:00;20792921;46758;19756507;45908;95;386757;1.86
2022-09-26 00:00:00;20833109;40188;19800764;44257;85;386842;1.86
2022-09-27 00:00:00;20869714;36605;19860311;59547;101;386943;1.85
2022-09-28 00:00:00;20909731;40017;19921826;61515;111;387054;1.85
2022-09-29 00:00:00;20948470;38739;19979763;57937;109;387163;1.85
2022-09-30 00:00:00;20985756;37286;20040988;61225;106;387269;1.85
2022-10-01 00:00:00;21018942;33186;20093616;52628;103;387372;1.84
2022-10-02 00:00:00;21049027;30085;20140608;46992;96;387468;1.84
2022-10-03 00:00:00;21073185;24158;20175902;35294;91;387559;1.84
2022-10-04 00:00:00;21094872;21687;20221339;45437;107;387666;1.84
2022-10-05 00:00:00;21118629;23757;20266033;44694;113;387779;1.84
2022-10-06 00:00:00;21141674;23045;20307569;41536;108;387887;1.83
2022-10-07 00:00:00;21163942;22268;20347142;39573;104;387991;1.83
2022-10-08 00:00:00;21184513;20571;20385431;38289;106;388097;1.83
2022-10-09 00:00:00;21203332;18819;20414224;28793;102;388199;1.83
2022-10-10 00:00:00;21218993;15661;20439043;24819;96;388295;1.83
2022-10-11 00:00:00;21232963;13970;20470552;31509;109;388404;1.83
2022-10-12 00:00:00;21248603;15640;20500961;30409;105;388509;1.83
2022-10-13 00:00:00;21264080;15477;20531754;30793;101;388610;1.83
2022-10-14 00:00:00;21278816;14736;20559274;27520;99;388709;1.83
2022-10-15 00:00:00;21292200;13384;20585404;26130;98;388807;1.83
2022-10-16 00:00:00;21304554;12354;20603845;18441;94;388901;1.83
2022-10-17 00:00:00;21314957;10403;20618358;14513;92;388993;1.82
2022-10-18 00:00:00;21324431;9474;20638610;20252;91;389084;1.82
2022-10-19 00:00:00;21335087;10656;20659469;20859;92;389176;1.82
2022-10-20 00:00:00;21345154;10067;20677821;18352;90;389266;1.82
2022-10-21 00:00:00;21354915;9761;20693493;15672;93;389359;1.82
2022-10-22 00:00:00;21364263;9348;20708528;15035;90;389449;1.82
2022-10-23 00:00:00;21372935;8672;20719106;10578;88;389537;1.82
2022-10-24 00:00:00;21380264;7329;20727435;8329;89;389626;1.82
2022-10-25 00:00:00;21386842;6578;20740347;12912;84;389710;1.82
2022-10-26 00:00:00;21394360;7518;20751864;11517;80;389790;1.82
2022-10-27 00:00:00;21402209;7849;20763904;12040;82;389872;1.82
2022-10-28 00:00:00;21409815;7606;20775589;11685;78;389950;1.82
2022-10-29 00:00:00;21416922;7107;20787116;11527;79;390029;1.82
2022-10-30 00:00:00;21423725;6803;20796124;9008;75;390104;1.82
2022-10-31 00:00:00;21429506;5781;20803197;7073;71;390175;1.82
2022-11-01 00:00:00;21434758;5252;20812505;9308;72;390247;1.82
2022-11-02 00:00:00;21441143;6385;20822746;10241;68;390315;1.82
2022-11-03 00:00:00;21447518;6375;20832520;9774;73;390388;1.82
2022-11-04 00:00:00;21453667;6149;20841779;9259;71;390459;1.82
2022-11-05 00:00:00;21459284;5617;20849598;7819;67;390526;1.82
2022-11-06 00:00:00;21463850;4566;20855333;5735;62;390588;1.82
2022-11-07 00:00:00;21468271;4421;20860277;4944;61;390649;1.82
2022-11-08 00:00:00;21472591;4320;20868400;8123;63;390712;1.82
2022-11-09 00:00:00;21477926;5335;20876892;8492;62;390774;1.82
2022-11-10 00:00:00;21483520;5594;20884515;7623;61;390835;1.82
2022-11-11 00:00:00;21489074;5554;20890728;6213;67;390902;1.82
2022-11-12 00:00:00;21494588;5514;20896445;5717;62;390964;1.82
2022-11-13 00:00:00;21499952;5364;20901517;5072;60;391024;1.82
2022-11-14 00:00:00;21504530;4578;20905977;4460;61;391085;1.82
2022-11-15 00:00:00;21508961;4431;20912331;6354;64;391149;1.82
2022-11-16 00:00:00;21514341;5380;20919237;6906;63;391212;1.82
2022-11-17 00:00:00;21520021;5680;20925972;6735;61;391273;1.82
2022-11-18 00:00:00;21525567;5546;20932860;6888;60;391333;1.82
2022-11-19 00:00:00;21531012;5445;20939481;6621;62;391395;1.82
2022-11-20 00:00:00;21536229;5217;20943924;4443;59;391454;1.82
2022-11-21 00:00:00;21540891;4662;20948088;4164;55;391509;1.82
2022-11-22 00:00:00;21545351;4460;20954532;6444;59;391568;1.82
2022-11-23 00:00:00;21550982;5631;20961317;6785;54;391622;1.82
2022-11-24 00:00:00;21556766;5784;20967429;6112;58;391680;1.82
2022-11-25 00:00:00;21562758;5992;20972766;5337;56;391736;1.82
2022-11-26 00:00:00;21568846;6088;20977854;5088;53;391789;1.82
2022-11-27 00:00:00;21574764;5918;20982028;4174;51;391840;1.82
2022-11-28 00:00:00;21579812;5048;20986290;4262;50;391890;1.82
2022-11-29 00:00:00;21584740;4928;20992153;5863;53;391943;1.82
2022-11-30 00:00:00;21590828;6088;20997710;5557;59;392002;1.82
2022-12-01 00:00:00;21597613;6785;21003575;5865;58;392060;1.82
2022-12-02 00:00:00;21604334;6721;21009259;5684;57;392117;1.81
2022-12-03 00:00:00;21611003;6669;21014391;5132;59;392176;1.81
2022-12-04 00:00:00;21617601;6598;21018980;4589;55;392231;1.81
2022-12-05 00:00:00;21623268;5667;21023627;4647;52;392283;1.81
2022-12-06 00:00:00;21628829;5561;21030317;6690;59;392342;1.81
2022-12-07 00:00:00;21635764;6935;21037111;6794;58;392400;1.81
2022-12-08 00:00:00;21643194;7430;21043426;6315;54;392454;1.81
2022-12-09 00:00:00;21650659;7465;21049420;5994;52;392506;1.81
2022-12-10 00:00:00;21658056;7397;21055866;6446;54;392560;1.81
2022-12-11 00:00:00;21665152;7096;21061584;5718;51;392611;1.81
2022-12-12 00:00:00;21671528;6376;21066616;5032;50;392661;1.81
2022-12-13 00:00:00;21677505;5977;21073454;6838;59;392720;1.81
2022-12-14 00:00:00;21685037;7532;21081129;7675;55;392775;1.81
2022-12-15 00:00:00;21692870;7833;21088668;7539;57;392832;1.81
2022-12-16 00:00:00;21701321;8451;21096061;7393;59;392891;1.81
2022-12-17 00:00:00;21708852;7531;21103330;7269;58;392949;1.81
2022-12-18 00:00:00;21716074;7222;21109668;6338;51;393000;1.81
2022-12-19 00:00:00;21722415;6341;21115232;5564;50;393050;1.81
2022-12-20 00:00:00;21728409;5994;21123341;8109;57;393107;1.81
2022-12-21 00:00:00;21735851;7442;21131700;8359;59;393166;1.81
2022-12-22 00:00:00;21743302;7451;21140943;9243;54;393220;1.81
2022-12-23 00:00:00;21750711;7409;21149218;8275;57;393277;1.81
2022-12-24 00:00:00;21757697;6986;21157222;8004;54;393331;1.81
2022-12-25 00:00:00;21764292;6595;21163398;6176;52;393383;1.81
2022-12-26 00:00:00;21769627;5335;21168975;5577;50;393433;1.81
2022-12-27 00:00:00;21774824;5197;21176667;7692;59;393492;1.81
2022-12-28 00:00:00;21781026;6202;21184777;8110;56;393548;1.81
2022-12-29 00:00:00;21787172;6146;21192592;7815;56;393604;1.81
2022-12-30 00:00:00;21792982;5810;21200287;7695;50;393654;1.81
2022-12-31 00:00:00;21798509;5527;21207802;7515;58;393712;1.81
2023-01-01 00:00:00;21803547;5038;21213085;5283;50;393762;1.81
2023-01-02 00:00:00;21807431;3884;21217574;4489;43;393805;1.81
2023-01-03 00:00:00;21810511;3080;21223056;5482;48;393853;1.81
2023-01-04 00:00:00;21813839;3328;21227998;4942;45;393898;1.81
2023-01-05 00:00:00;21817113;3274;21232717;4719;47;393945;1.81
2023-01-06 00:00:00;21820552;3439;21237402;4685;41;393986;1.81
2023-01-07 00:00:00;21823855;3303;21241865;4463;49;394035;1.81
2023-01-08 00:00:00;21826982;3127;21245559;3694;45;394080;1.81
2023-01-09 00:00:00;21829736;2754;21248549;2990;41;394121;1.81
2023-01-10 00:00:00;21832768;3032;21253611;5062;47;394168;1.81
2023-01-11 00:00:00;21836969;4201;21258733;5122;46;394214;1.81
2023-01-12 00:00:00;21841644;4675;21263274;4541;48;394262;1.81
2023-01-13 00:00:00;21846722;5078;21267545;4271;47;394309;1.8